receive_timestamp,source_vehicle,message_id,event_type,send_timestamp,latency_us
18841344382,36,1,receive,18841304421,39961
18841345022,140,1,receive,18841304658,40364
18841345547,98,1,receive,18841305340,40207
18841346053,154,1,receive,18841309047,37006
18841346632,42,1,receive,18841310243,36389
18841347195,120,1,receive,18841311208,35987
18841347686,54,1,receive,18841311456,36230
18841348200,56,1,receive,18841311654,36546
18841348877,26,1,receive,18841312773,36104
18841349385,86,2,receive,18841317062,32323
18841349849,76,1,receive,18841318245,31604
18841512318,40,1,receive,18841319217,193101
18841512663,140,2,receive,18841322159,190504
18841512990,84,1,receive,18841323743,189247
18841513316,66,1,receive,18841324019,189297
18841513716,70,1,receive,18841326788,186928
18841514047,70,2,receive,18841327272,186775
18841514417,34,2,receive,18841328992,185425
18841514751,100,1,receive,18841329814,184937
18841515660,136,1,receive,18841330056,185604
18841516045,126,1,receive,18841330084,185961
18841516420,96,1,receive,18841331263,185157
18841516759,96,2,receive,18841331899,184860
18841517099,140,3,receive,18841332856,184243
18841517439,102,1,receive,18841332884,184555
18841517773,122,1,receive,18841333860,183913
18841518103,76,2,receive,18841334009,184094
18841518616,120,2,receive,18841334414,184202
18841519057,118,1,receive,18841335105,183952
18841519438,118,2,receive,18841335873,183565
18841519825,140,4,receive,18841337258,182567
18841798208,138,1,receive,18841338523,459685
18841798579,120,3,receive,18841338815,459764
18841798940,56,2,receive,18841339254,459686
18841799382,28,2,receive,18841340023,459359
18841799751,80,2,receive,18841341130,458621
18841800151,6,1,receive,18841341213,458938
18841800490,34,3,receive,18841341509,458981
18841800863,86,3,receive,18841341639,459224
18841801249,38,1,receive,18841341795,459454
18841801636,86,4,receive,18841342029,459607
18841802023,118,3,receive,18841342899,459124
18841802433,140,5,receive,18841345630,456803
18841802824,76,3,receive,18841345913,456911
18841803212,64,1,receive,18841346302,456910
18841803596,10,1,receive,18841346504,457092
18841803997,92,2,receive,18841347742,456255
18841804400,52,2,receive,18841348572,455828
18841804781,140,6,receive,18841348951,455830
18841950117,142,1,receive,18841349378,600739
18841950444,54,2,receive,18841349713,600731
18841950758,120,4,receive,18841350221,600537
18841951118,16,1,receive,18841352218,598900
18841951439,48,1,receive,18841352766,598673
18841951754,8,1,receive,18841353060,598694
18841952129,110,1,receive,18841353267,598862
18841952462,86,5,receive,18841353353,599109
18841952789,158,2,receive,18841354631,598158
18841953182,50,1,receive,18841354700,598482
18841953509,36,2,receive,18841354783,598726
18841953832,154,2,receive,18841355166,598666
18841954239,76,4,receive,18841355306,598933
18841954609,156,1,receive,18841356683,597926
18841955005,20,2,receive,18841357182,597823
18841955338,40,2,receive,18841357689,597649
18842060527,24,1,receive,18841357913,702614
18842061100,192,1,receive,18841358295,702805
18842061438,26,2,receive,18841359280,702158
18842061809,66,2,receive,18841359433,702376
18842062282,30,1,receive,18841360804,701478
18842062677,150,1,receive,18841360895,701782
18842063025,96,3,receive,18841361211,701814
18842063604,132,1,receive,18841361305,702299
18842063982,42,2,receive,18841362809,701173
18842064382,46,1,receive,18841362920,701462
18842064722,114,1,receive,18841364200,700522
18842065101,88,1,receive,18841364557,700544
18842065441,20,3,receive,18841365456,699985
18842190038,96,4,receive,18841365704,824334
18842190396,84,2,receive,18841366799,823597
18842190850,40,3,receive,18841366904,823946
18842191191,120,5,receive,18841367514,823677
18842191564,136,2,receive,18841367664,823900
18842191891,2,1,receive,18841369372,822519
18842192254,80,3,receive,18841369642,822612
18842192582,34,4,receive,18841370016,822566
18842193029,112,1,receive,18841370738,822291
18842193370,78,1,receive,18841372617,820753
18842193741,104,1,receive,18841373015,820726
18842194110,98,2,receive,18841373202,820908
18842194497,184,1,receive,18841373484,821013
18842194879,180,1,receive,18841374003,820876
18842239924,86,6,receive,18841374688,865236
18842240372,60,1,receive,18841375025,865347
18842240832,12,1,receive,18841375431,865401
18842241192,128,1,receive,18841376126,865066
18842241638,136,3,receive,18841376934,864704
18842242033,80,4,receive,18841377901,864132
18842242453,154,3,receive,18841378095,864358
18842242810,126,2,receive,18841378314,864496
18842243204,192,2,receive,18841378700,864504
18842243554,190,1,receive,18841380050,863504
18842243941,124,1,receive,18841380566,863375
18842244289,6,2,receive,18841380910,863379
18842315704,28,3,receive,18841381006,934698
18842316062,146,1,receive,18841381406,934656
18842316443,166,1,receive,18841381576,934867
18842316855,144,1,receive,18841381709,935146
18842317481,62,1,receive,18841382102,935379
18842317836,134,1,receive,18841382195,935641
18842318224,140,7,receive,18841382284,935940
18842318572,164,1,receive,18841382545,936027
18842319033,36,3,receive,18841383315,935718
18842319441,76,5,receive,18841383766,935675
18842319844,76,6,receive,18841383973,935871
18842320254,106,1,receive,18841384342,935912
18842320643,38,2,receive,18841384942,935701
18842348902,102,2,receive,18841385390,963512
18842349329,122,2,receive,18841385759,963570
18842349701,188,1,receive,18841385938,963763
18842350087,92,3,receive,18841386262,963825
18842350458,170,1,receive,18841388448,962010
18842350884,52,3,receive,18841389199,961685
18842351255,6,3,receive,18841390009,961246
18842351694,152,1,receive,18841390024,961670
18842352112,28,4,receive,18841391342,960770
18842352492,156,2,receive,18841392769,959723
18842352863,168,1,receive,18841393182,959681
18842353265,14,1,receive,18841394788,958477
18842400425,56,3,receive,18841394879,1005546
18842400835,154,4,receive,18841395438,1005397
18842401220,6,4,receive,18841396300,1004920
18842401593,86,7,receive,18841396895,1004698
18842402002,54,3,receive,18841397175,1004827
18842402379,126,3,receive,18841398254,1004125
18842402777,156,3,receive,18841398552,1004225
18842403153,120,6,receive,18841398863,1004290
18842403511,36,4,receive,18841399133,1004378
18842403867,42,3,receive,18841399372,1004495
18842404223,70,3,receive,18841399851,1004372
18842404585,48,2,receive,18841400154,1004431
18842405013,118,4,receive,18841400269,1004744
18842405383,158,3,receive,18841402023,1003360
18842405755,178,1,receive,18841402480,1003275
18842406122,70,4,receive,18841404117,1002005
18842454969,84,3,receive,18841404244,1050725
18842455382,146,2,receive,18841404704,1050678
18842455775,138,2,receive,18841405178,1050597
18842456216,26,3,receive,18841405602,1050614
18842456592,120,7,receive,18841406062,1050530
18842456959,76,7,receive,18841406334,1050625
18842457329,80,5,receive,18841407310,1050019
18842457699,136,4,receive,18841408450,1049249
18842458151,118,5,receive,18841409639,1048512
18842458532,74,1,receive,18841409941,1048591
18842458902,34,5,receive,18841409983,1048919
18842459272,192,3,receive,18841410163,1049109
18842459643,40,4,receive,18841410392,1049251
18842505756,122,3,receive,18841410490,1095266
18842506143,142,2,receive,18841410654,1095489
18842506515,86,8,receive,18841411176,1095339
18842506882,6,5,receive,18841411424,1095458
18842507325,144,2,receive,18841411857,1095468
18842507697,16,2,receive,18841412216,1095481
18842508065,180,2,receive,18841412571,1095494
18842508490,150,2,receive,18841412613,1095877
18842508850,94,1,receive,18841412614,1096236
18842509280,64,2,receive,18841413663,1095617
18842509714,126,4,receive,18841415105,1094609
18842510094,38,3,receive,18841415464,1094630
18842547677,96,5,receive,18841415720,1131957
18842548072,194,1,receive,18841415814,1132258
18842548445,200,1,receive,18841415786,1132659
18842548818,98,3,receive,18841416110,1132708
18842549239,158,4,receive,18841416244,1132995
18842549622,114,2,receive,18841417053,1132569
18842550083,66,3,receive,18841417220,1132863
18842550452,46,2,receive,18841417578,1132874
18842550821,120,8,receive,18841418274,1132547
18842551189,36,5,receive,18841418363,1132826
18842551557,136,5,receive,18841418779,1132778
18842552012,46,3,receive,18841419594,1132418
18842552451,56,4,receive,18841419746,1132705
18842600895,122,4,receive,18841419853,1181042
18842601296,188,2,receive,18841420914,1180382
18842601673,162,1,receive,18841420931,1180742
18842602041,152,2,receive,18841421553,1180488
18842602410,52,4,receive,18841421620,1180790
18842602806,102,3,receive,18841422110,1180696
18842603201,76,8,receive,18841422313,1180888
18842603569,26,4,receive,18841423914,1179655
18842604039,140,8,receive,18841424670,1179369
18842605084,176,1,receive,18841425565,1179519
18842605687,84,4,receive,18841425678,1180009
18842606077,164,2,receive,18841427217,1178860
18842606449,168,2,receive,18841427524,1178925
18842659380,172,1,receive,18841427625,1231755
18842659803,158,5,receive,18841428464,1231339
18842660202,132,2,receive,18841428579,1231623
18842660583,118,6,receive,18841429393,1231190
18842660977,150,3,receive,18841429975,1231002
18842661415,140,9,receive,18841430860,1230555
18842661783,140,10,receive,18841431015,1230768
18842662158,64,3,receive,18841431338,1230820
18842662520,28,5,receive,18841431670,1230850
18842662915,78,2,receive,18841433479,1229436
18842663295,186,1,receive,18841434160,1229135
18842663682,184,2,receive,18841434274,1229408
18842664047,106,2,receive,18841434815,1229232
18842713156,46,4,receive,18841435295,1277861
18842713534,6,6,receive,18841435479,1278055
18842713899,64,4,receive,18841435682,1278217
18842714275,30,2,receive,18841436304,1277971
18842714744,92,4,receive,18841436913,1277831
18842715211,132,3,receive,18841439057,1276154
18842715595,112,2,receive,18841439377,1276218
18842715982,60,2,receive,18841440018,1275964
18842716360,122,5,receive,18841440303,1276057
18842716817,110,2,receive,18841440292,1276525
18842717199,200,2,receive,18841440539,1276660
18842717642,102,4,receive,18841440645,1276997
18842718056,174,1,receive,18841441323,1276733
18842766543,22,1,receive,18841442093,1324450
18842767002,168,3,receive,18841442346,1324656
18842767394,76,9,receive,18841442614,1324780
18842767800,180,3,receive,18841442729,1325071
18842768274,154,5,receive,18841442939,1325335
18842768681,194,2,receive,18841443033,1325648
18842769065,14,2,receive,18841444078,1324987
18842769501,84,5,receive,18841444999,1324502
18842769871,140,11,receive,18841445235,1324636
18842770261,170,2,receive,18841445630,1324631
18842770633,70,5,receive,18841447520,1323113
18842771000,94,2,receive,18841448245,1322755
18842771428,138,3,receive,18841448355,1323073
18842771850,152,3,receive,18841448425,1323425
18842820647,158,6,receive,18841449746,1370901
18842821034,156,4,receive,18841449772,1371262
18842821408,42,4,receive,18841450340,1371068
18842821829,26,5,receive,18841451198,1370631
18842822272,16,3,receive,18841451391,1370881
18842822704,80,6,receive,18841452503,1370201
18842823090,66,4,receive,18841453576,1369514
18842823471,66,5,receive,18841453741,1369730
18842823914,24,2,receive,18841448067,1375847
18842824282,158,7,receive,18841453944,1370338
18842824652,88,2,receive,18841453971,1370681
18842825019,54,4,receive,18841454004,1371015
18842872938,104,2,receive,18841454291,1418647
18842873357,178,2,receive,18841454596,1418761
18842873791,48,3,receive,18841454817,1418974
18842874179,4,1,receive,18841455267,1418912
18842874549,162,2,receive,18841455911,1418638
18842874976,136,6,receive,18841456378,1418598
18842875371,132,4,receive,18841458545,1416826
18842875756,116,1,receive,18841458675,1417081
18842876132,80,7,receive,18841458793,1417339
18842876511,38,4,receive,18841459804,1416707
18842876931,114,3,receive,18841460010,1416921
18842877336,80,8,receive,18841460010,1417326
18842877715,30,3,receive,18841460014,1417701
18842878084,46,5,receive,18841460061,1418023
18842926305,124,2,receive,18841460306,1465999
18842926805,144,3,receive,18841460404,1466401
18842927211,86,9,receive,18841460496,1466715
18842927581,36,6,receive,18841460778,1466803
18842927949,36,7,receive,18841460926,1467023
18842928338,102,5,receive,18841460907,1467431
18842928727,34,6,receive,18841461034,1467693
18842929087,92,5,receive,18841461229,1467858
18842929442,76,10,receive,18841461908,1467534
18842929843,142,3,receive,18841462051,1467792
18842930233,40,5,receive,18841462518,1467715
18842930699,96,6,receive,18841462581,1468118
18842931075,146,3,receive,18841445866,1485209
18842931457,186,2,receive,18841464273,1467184
18842978912,56,5,receive,18841464548,1514364
18842979371,52,5,receive,18841465177,1514194
18842979784,142,4,receive,18841465292,1514492
18842980285,146,4,receive,18841465413,1514872
18842980720,70,6,receive,18841465807,1514913
18842981171,164,3,receive,18841466073,1515098
18842981601,56,6,receive,18841466766,1514835
18842982014,120,9,receive,18841467642,1514372
18842982423,118,7,receive,18841467833,1514590
18842982944,116,2,receive,18841468028,1514916
18842983366,48,4,receive,18841469240,1514126
18842983775,150,4,receive,18841469460,1514315
18843032379,114,4,receive,18841470010,1562369
18843032800,122,6,receive,18841470009,1562791
18843033180,24,3,receive,18841470696,1562484
18843033555,14,3,receive,18841472058,1561497
18843033958,164,4,receive,18841472296,1561662
18843034362,106,3,receive,18841472359,1562003
18843034746,64,5,receive,18841473159,1561587
18843035122,66,6,receive,18841473980,1561142
18843035502,12,2,receive,18841474171,1561331
18843035909,4,2,receive,18841474744,1561165
18843036360,76,11,receive,18841475188,1561172
18843036760,184,3,receive,18841475362,1561398
18843037143,14,4,receive,18841475441,1561702
18843084946,88,3,receive,18841475477,1609469
18843085360,28,6,receive,18841475984,1609376
18843085755,58,1,receive,18841477068,1608687
18843086139,12,3,receive,18841477429,1608710
18843086514,168,4,receive,18841477870,1608644
18843086978,112,3,receive,18841478966,1608012
18843087360,188,3,receive,18841480010,1607350
18843087734,94,3,receive,18841480009,1607725
18843088104,176,2,receive,18841480316,1607788
18843088473,38,5,receive,18841482074,1606399
18843088932,156,5,receive,18841482489,1606443
18843089308,106,4,receive,18841482810,1606498
18843136660,180,4,receive,18841483696,1652964
18843137083,134,2,receive,18841454589,1682494
18843137484,172,2,receive,18841484065,1653419
18843137876,180,5,receive,18841484890,1652986
18843138300,102,6,receive,18841485708,1652592
18843138823,78,3,receive,18841485852,1652971
18843139270,134,3,receive,18841485922,1653348
18843139851,106,5,receive,18841486074,1653777
18843140323,38,6,receive,18841486237,1654086
18843140741,92,6,receive,18841486565,1654176
18843141134,26,6,receive,18841486611,1654523
18843141524,92,7,receive,18841486773,1654751
18843189758,36,8,receive,18841487170,1702588
18843190191,124,3,receive,18841487563,1702628
18843190571,24,4,receive,18841487568,1703003
18843190939,16,4,receive,18841490023,1700916
18843191330,150,5,receive,18841490256,1701074
18843191746,48,5,receive,18841490373,1701373
18843192126,118,8,receive,18841490458,1701668
18843192497,84,6,receive,18841491411,1701086
18843192863,48,6,receive,18841491606,1701257
18843193222,146,5,receive,18841491771,1701451
18843193582,162,3,receive,18841492037,1701545
18843194051,28,7,receive,18841493230,1700821
18843194422,34,7,receive,18841493323,1701099
18843194785,154,6,receive,18841493365,1701420
18843242625,76,12,receive,18841493501,1749124
18843243027,186,3,receive,18841493599,1749428
18843243414,140,12,receive,18841493723,1749691
18843243786,40,6,receive,18841493863,1749923
18843244174,4,3,receive,18841494259,1749915
18843244585,38,7,receive,18841494423,1750162
18843245099,40,7,receive,18841495035,1750064
18843245517,54,5,receive,18841495395,1750122
18843245911,96,7,receive,18841496054,1749857
18843247027,42,5,receive,18841496142,1750885
18843247554,134,4,receive,18841497883,1749671
18843296173,12,4,receive,18841498154,1798019
18843296560,174,2,receive,18841498346,1798214
18843296986,48,7,receive,18841498843,1798143
18843297383,136,7,receive,18841498920,1798463
18843297771,132,5,receive,18841499405,1798366
18843298158,186,4,receive,18841499788,1798370
18843298528,120,10,receive,18841499893,1798635
18843298941,178,3,receive,18841500596,1798345
18843299308,26,7,receive,18841500840,1798468
18843299674,124,4,receive,18841500880,1798794
18843300054,140,13,receive,18841500933,1799121
18843300466,74,2,receive,18841471475,1828991
18843353308,96,8,receive,18841501222,1852086
18843353765,192,4,receive,18841466300,1887465
18843354301,178,4,receive,18841501778,1852523
18843354695,86,10,receive,18841501849,1852846
18843355477,138,4,receive,18841502033,1853444
18843355978,172,3,receive,18841502322,1853656
18843356366,158,8,receive,18841502289,1854077
18843356780,168,5,receive,18841502511,1854269
18843357166,134,5,receive,18841503120,1854046
18843357565,122,7,receive,18841504033,1853532
18843358029,70,7,receive,18841505238,1852791
18843358416,96,9,receive,18841505408,1853008
18843358811,128,2,receive,18841451092,1907719
18843407462,14,5,receive,18841506824,1900638
18843407862,80,9,receive,18841507479,1900383
18843408341,128,3,receive,18841508148,1900193
18843408736,28,8,receive,18841508538,1900198
18843409109,2,2,receive,18841478221,1930888
18843409464,64,6,receive,18841510539,1898925
18843409822,26,8,receive,18841511030,1898792
18843410307,154,7,receive,18841511583,1898724
18843410680,4,4,receive,18841511611,1899069
18843411053,118,9,receive,18841511777,1899276
18843411421,30,4,receive,18841512035,1899386
18843411810,94,4,receive,18841512680,1899130
18843412251,114,5,receive,18841512876,1899375
18843461104,46,6,receive,18841514651,1946453
18843461547,88,4,receive,18841514878,1946669
18843461931,124,5,receive,18841514983,1946948
18843462313,8,2,receive,18841515097,1947216
18843462757,8,3,receive,18841515283,1947474
18843463249,184,4,receive,18841515603,1947646
18843463639,114,6,receive,18841516092,1947547
18843464022,116,3,receive,18841508921,1955101
18843464486,128,4,receive,18841516592,1947894
18843464866,114,7,receive,18841517257,1947609
18843465237,122,8,receive,18841518240,1946997
18843465632,24,5,receive,18841518855,1946777
18843466002,140,14,receive,18841519145,1946857
18843514217,162,4,receive,18841520028,1994189
18843514599,86,11,receive,18841520079,1994520
18843514963,76,13,receive,18841520782,1994181
18843515324,64,7,receive,18841520789,1994535
18843515685,180,6,receive,18841521117,1994568
18843516121,48,8,receive,18841521129,1994992
18843516491,96,10,receive,18841521628,1994863
18843516861,174,3,receive,18841522068,1994793
18843517234,70,8,receive,18841522470,1994764
18843517607,136,8,receive,18841524167,1993440
18843518073,164,5,receive,18841524328,1993745
18843518436,42,6,receive,18841524508,1993928
18843518852,192,5,receive,18841524910,1993942
18843566709,156,6,receive,18841525765,2040944
18843567101,128,5,receive,18841526827,2040274
18843567469,178,5,receive,18841526988,2040481
18843567964,118,10,receive,18841528989,2038975
18843568366,84,7,receive,18841529671,2038695
18843568744,150,6,receive,18841531116,2037628
18843569119,40,8,receive,18841531365,2037754
18843569490,146,6,receive,18841531387,2038103
18843569947,38,8,receive,18841531695,2038252
18843570729,188,4,receive,18841531881,2038848
18843571283,42,7,receive,18841532761,2038522
18843571660,120,11,receive,18841533253,2038407
18843619739,188,5,receive,18841534140,2085599
18843620181,78,4,receive,18841535175,2085006
18843620651,114,8,receive,18841535472,2085179
18843621103,24,6,receive,18841536082,2085021
18843621482,76,14,receive,18841537023,2084459
18843621891,150,7,receive,18841537333,2084558
18843622259,148,1,receive,18841537877,2084382
18843622733,96,11,receive,18841537926,2084807
18843623128,168,6,receive,18841538653,2084475
18843623511,154,8,receive,18841538835,2084676
18843623890,134,6,receive,18841539377,2084513
18843624262,134,7,receive,18841539530,2084732
18843624711,34,8,receive,18841539584,2085127
18843677043,106,6,receive,18841537066,2139977
18843677466,192,6,receive,18841540292,2137174
18843677884,70,9,receive,18841540685,2137199
18843678394,128,6,receive,18841542078,2136316
18843678780,172,4,receive,18841542152,2136628
18843679142,46,7,receive,18841543130,2136012
18843679506,34,9,receive,18841543855,2135651
18843679882,28,9,receive,18841543860,2136022
18843680279,84,8,receive,18841544085,2136194
18843680742,118,11,receive,18841544269,2136473
18843681130,162,5,receive,18841544304,2136826
18843681515,30,5,receive,18841544287,2137228
18843681887,166,2,receive,18841389871,2292016
18843732680,158,9,receive,18841544666,2188014
18843733068,134,8,receive,18841544681,2188387
18843733443,54,6,receive,18841545284,2188159
18843733807,158,10,receive,18841545832,2187975
18843734299,164,6,receive,18841546640,2187659
18843734673,180,7,receive,18841547371,2187302
18843735033,108,1,receive,18841548209,2186824
18843735391,138,5,receive,18841549309,2186082
18843735813,14,6,receive,18841549873,2185940
18843736261,20,4,receive,18841411866,2324395
18843736639,64,8,receive,18841550149,2186490
18843737016,44,1,receive,18841550178,2186838
18843737391,120,12,receive,18841551474,2185917
18843785079,192,7,receive,18841551593,2233486
18843785484,70,10,receive,18841551916,2233568
18843785899,28,10,receive,18841552038,2233861
18843786280,122,9,receive,18841554838,2231442
18843786659,80,10,receive,18841555980,2230679
18843787099,116,4,receive,18841556215,2230884
18843787477,28,11,receive,18841556211,2231266
18843787857,84,9,receive,18841556371,2231486
18843788232,2,3,receive,18841557184,2231048
18843788609,82,1,receive,18841558026,2230583
18843789037,76,15,receive,18841558303,2230734
18843789482,26,9,receive,18841558407,2231075
18843789874,24,7,receive,18841559341,2230533
18843790287,46,8,receive,18841559425,2230862
18843838212,164,7,receive,18841559861,2278351
18843838621,8,4,receive,18841561406,2277215
18843838995,184,5,receive,18841562656,2276339
18843839468,132,6,receive,18841562754,2276714
18843839872,140,15,receive,18841563520,2276352
18843840282,42,8,receive,18841564149,2276133
18843841002,70,11,receive,18841565166,2275836
18843841382,146,7,receive,18841565743,2275639
18843841756,154,9,receive,18841566112,2275644
18843842122,4,5,receive,18841566381,2275741
18843842491,10,2,receive,18841418508,2423983
18843842959,150,8,receive,18841566586,2276373
18843843355,48,9,receive,18841566973,2276382
18843890532,174,4,receive,18841567347,2323185
18843890926,44,2,receive,18841568500,2322426
18843891316,128,7,receive,18841569375,2321941
18843891679,26,10,receive,18841569620,2322059
18843892045,38,9,receive,18841569937,2322108
18843892509,182,1,receive,18841570033,2322476
18843892905,106,7,receive,18841571337,2321568
18843893283,178,6,receive,18841571376,2321907
18843893651,136,9,receive,18841572649,2321002
18843894089,40,9,receive,18841572703,2321386
18843894485,56,7,receive,18841517272,2377213
18843894859,144,4,receive,18841520012,2374847
18843937922,118,12,receive,18841573531,2364391
18843938342,46,9,receive,18841573738,2364604
18843939036,158,11,receive,18841574102,2364934
18843939497,90,1,receive,18841574373,2365124
18843940022,4,6,receive,18841574591,2365431
18843940416,26,11,receive,18841574804,2365612
18843940876,78,5,receive,18841576557,2364319
18843941255,10,3,receive,18841576599,2364656
18843941717,30,6,receive,18841576676,2365041
18843942090,98,4,receive,18841456372,2485718
18843991224,98,5,receive,18841576897,2414327
18843991612,118,13,receive,18841577732,2413880
18843991983,48,10,receive,18841578237,2413746
18843992342,96,12,receive,18841578330,2414012
18843992698,2,4,receive,18841579521,2413177
18843993149,154,10,receive,18841580007,2413142
18843993562,190,2,receive,18841510019,2483543
18843993924,174,5,receive,18841580547,2413377
18843994281,120,13,receive,18841580710,2413571
18843995040,42,9,receive,18841582362,2412678
18843995408,162,6,receive,18841584118,2411290
18843995790,154,11,receive,18841585203,2410587
18843996260,2,5,receive,18841585782,2410478
18843996632,46,10,receive,18841586072,2410560
18843996995,132,7,receive,18841586073,2410922
18844045182,80,11,receive,18841586319,2458863
18844045572,64,9,receive,18841587566,2458006
18844045947,94,5,receive,18841557061,2488886
18844046465,168,7,receive,18841588195,2458270
18844046868,34,10,receive,18841588292,2458576
18844047262,114,9,receive,18841577858,2469404
18844047633,82,2,receive,18841589429,2458204
18844048003,82,3,receive,18841589609,2458394
18844048374,112,4,receive,18841493445,2554929
18844048745,54,7,receive,18841590647,2458098
18844049200,150,9,receive,18841591095,2458105
18844049582,96,13,receive,18841591578,2458004
18844049959,82,4,receive,18841591844,2458115
18844099243,196,1,receive,18841591887,2507356
18844099642,162,7,receive,18841592278,2507364
18844100020,178,7,receive,18841592466,2507554
18844100388,162,8,receive,18841593439,2506949
18844100753,166,3,receive,18841593950,2506803
18844101153,38,10,receive,18841594243,2506910
18844101561,112,5,receive,18841594477,2507084
18844101932,174,6,receive,18841594750,2507182
18844102375,70,12,receive,18841595721,2506654
18844102766,174,7,receive,18841596903,2505863
18844103147,60,3,receive,18841488048,2615099
18844103509,130,2,receive,18841332370,2771139
18844103867,134,9,receive,18841598435,2505432
18844156637,116,5,receive,18841598645,2557992
18844157054,14,7,receive,18841599297,2557757
18844157436,28,12,receive,18841599498,2557938
18844157907,28,13,receive,18841599654,2558253
18844158314,138,6,receive,18841599874,2558440
18844158756,146,8,receive,18841599885,2558871
18844159141,146,9,receive,18841600075,2559066
18844159526,140,16,receive,18841600882,2558644
18844159909,122,10,receive,18841601136,2558773
18844160305,14,8,receive,18841601473,2558832
18844160755,76,16,receive,18841601874,2558881
18844161149,26,12,receive,18841601983,2559166
18844209082,192,8,receive,18841602249,2606833
18844209486,128,8,receive,18841602719,2606767
18844209859,96,14,receive,18841602857,2607002
18844210253,128,9,receive,18841602922,2607331
18844210681,150,10,receive,18841603277,2607404
18844211100,122,11,receive,18841603429,2607671
18844211581,116,6,receive,18841603814,2607767
18844212052,56,8,receive,18841604020,2608032
18844212449,140,17,receive,18841604135,2608314
18844212841,24,8,receive,18841605910,2606931
18844213227,122,12,receive,18841607661,2605566
18844213617,186,5,receive,18841524036,2689581
18844214153,184,6,receive,18841608202,2605951
18844214572,132,8,receive,18841608378,2606194
18844263550,36,9,receive,18841535781,2727769
18844264040,64,10,receive,18841609526,2654514
18844264419,112,6,receive,18841609804,2654615
18844264791,142,5,receive,18841499817,2764974
18844265163,44,3,receive,18841609890,2655273
18844265534,104,3,receive,18841509649,2755885
18844266079,8,5,receive,18841611055,2655024
18844266538,146,10,receive,18841611300,2655238
18844266917,8,6,receive,18841612305,2654612
18844267279,44,4,receive,18841613081,2654198
18844267638,120,14,receive,18841613134,2654504
18844267999,6,7,receive,18841467879,2800120
18844315615,78,6,receive,18841613968,2701647
18844316040,68,1,receive,18841614228,2701812
18844316438,146,11,receive,18841615470,2700968
18844316889,24,9,receive,18841616099,2700790
18844317256,140,18,receive,18841616320,2700936
18844317620,134,10,receive,18841616670,2700950
18844319725,54,8,receive,18841616954,2702771
18844320147,194,3,receive,18841492562,2827585
18844367812,136,10,receive,18841619025,2748787
18844368224,46,11,receive,18841619468,2748756
18844368618,126,5,receive,18841433446,2935172
18844369003,158,12,receive,18841621580,2747423
18844369481,78,7,receive,18841622119,2747362
18844369856,166,4,receive,18841622271,2747585
18844370248,130,3,receive,18841622963,2747285
18844370623,98,6,receive,18841623227,2747396
18844370997,30,7,receive,18841624208,2746789
18844371435,132,9,receive,18841624692,2746743
18844371811,190,3,receive,18841625080,2746731
18844372234,96,15,receive,18841625129,2747105
18844372591,118,14,receive,18841625155,2747436
18844421324,124,6,receive,18841544081,2877243
18844421720,168,8,receive,18841625747,2795973
18844422175,106,8,receive,18841626172,2796003
18844422631,104,4,receive,18841626236,2796395
18844423027,184,7,receive,18841626464,2796563
18844423412,14,9,receive,18841626725,2796687
18844423800,38,11,receive,18841627627,2796173
18844424249,178,8,receive,18841627759,2796490
18844424704,42,10,receive,18841629756,2794948
18844425122,10,4,receive,18841630008,2795114
18844425513,162,9,receive,18841630808,2794705
18844425904,14,10,receive,18841630907,2794997
18844426314,138,7,receive,18841631178,2795136
18844426711,44,5,receive,18841631384,2795327
18844427159,154,12,receive,18841631539,2795620
18844475138,192,9,receive,18841633530,2841608
18844475540,34,11,receive,18841633706,2841834
18844475924,38,12,receive,18841635776,2840148
18844476297,80,12,receive,18841635817,2840480
18844476670,132,10,receive,18841635962,2840708
18844477113,14,11,receive,18841636058,2841055
18844477495,158,13,receive,18841636768,2840727
18844477880,26,13,receive,18841637182,2840698
18844478436,114,10,receive,18841637372,2841064
18844478872,102,7,receive,18841537843,2941029
18844479269,96,16,receive,18841638378,2840891
18844479696,96,17,receive,18841638584,2841112
18844527945,36,10,receive,18841638591,2889354
18844528347,60,4,receive,18841638825,2889522
18844528815,64,11,receive,18841638839,2889976
18844529202,48,11,receive,18841639009,2890193
18844529638,82,5,receive,18841639206,2890432
18844530021,160,1,receive,18841639352,2890669
18844530425,30,8,receive,18841639485,2890940
18844530809,140,19,receive,18841639526,2891283
18844531176,22,2,receive,18841524382,3006794
18844531532,170,3,receive,18841477321,3054211
18844531893,8,7,receive,18841640654,2891239
18844532252,166,5,receive,18841641497,2890755
18844532700,154,13,receive,18841641715,2890985
18844580181,112,7,receive,18841642235,2937946
18844580583,146,12,receive,18841642736,2937847
18844581052,30,9,receive,18841643674,2937378
18844581461,116,7,receive,18841643883,2937578
18844581849,122,13,receive,18841644032,2937817
18844582244,130,4,receive,18841644181,2938063
18844582666,114,11,receive,18841645541,2937125
18844583058,150,11,receive,18841645893,2937165
18844583443,142,6,receive,18841646053,2937390
18844583817,74,3,receive,18841544086,3039731
18844584191,54,9,receive,18841646286,2937905
18844584621,52,6,receive,18841512631,3071990
18844633827,166,6,receive,18841646753,2987074
18844634324,158,14,receive,18841646942,2987382
18844634784,76,17,receive,18841647204,2987580
18844635161,132,11,receive,18841648242,2986919
18844635556,28,14,receive,18841649052,2986504
18844635924,22,3,receive,18841649886,2986038
18844636280,100,2,receive,18841369790,3266490
18844636731,86,12,receive,18841549382,3087349
18844637109,104,5,receive,18841650583,2986526
18844637476,142,7,receive,18841651232,2986244
18844637840,120,15,receive,18841651893,2985947
18844638263,118,15,receive,18841652429,2985834
18844681777,136,11,receive,18841653291,3028486
18844682451,140,20,receive,18841653792,3028659
18844683414,126,6,receive,18841653949,3029465
18844683861,28,15,receive,18841654258,3029603
18844684260,48,12,receive,18841655293,3028967
18844684656,116,8,receive,18841656211,3028445
18844685053,194,4,receive,18841656437,3028616
18844685446,44,6,receive,18841656647,3028799
18844686013,48,13,receive,18841657511,3028502
18844728843,158,15,receive,18841658145,3070698
18844729293,46,12,receive,18841659816,3069477
18844729808,36,11,receive,18841660988,3068820
18844730224,6,8,receive,18841661968,3068256
18844730621,190,4,receive,18841662468,3068153
18844731011,118,16,receive,18841662614,3068397
18844731472,102,8,receive,18841664379,3067093
18844731858,106,9,receive,18841664534,3067324
18844732238,112,8,receive,18841665521,3066717
18844732612,154,14,receive,18841665902,3066710
18844732992,60,5,receive,18841666202,3066790
18844776464,80,13,receive,18841666381,3110083
18844776852,162,10,receive,18841667086,3109766
18844777219,100,3,receive,18841667245,3109974
18844777605,184,8,receive,18841667787,3109818
18844778041,104,6,receive,18841667833,3110208
18844778430,184,9,receive,18841667983,3110447
18844778876,42,11,receive,18841668104,3110772
18844779271,112,9,receive,18841668761,3110510
18844779657,118,17,receive,18841669760,3109897
18844780191,138,8,receive,18841670480,3109711
18844780581,96,18,receive,18841670935,3109646
18844780962,96,19,receive,18841671119,3109843
18844828791,10,5,receive,18841671389,3157402
18844829674,106,10,receive,18841671696,3157978
18844830135,98,7,receive,18841672527,3157608
18844830565,118,18,receive,18841673931,3156634
18844830961,34,12,receive,18841674075,3156886
18844831345,102,9,receive,18841674644,3156701
18844831726,190,5,receive,18841674718,3157008
18844832136,120,16,receive,18841675074,3157062
18844832516,30,10,receive,18841675063,3157453
18844832888,100,4,receive,18841675452,3157436
18844833273,80,14,receive,18841676143,3157130
18844833742,118,19,receive,18841677132,3156610
18844883402,150,12,receive,18841677171,3206231
18844884516,48,14,receive,18841677371,3207145
18844884930,76,18,receive,18841677472,3207458
18844885326,170,4,receive,18841677614,3207712
18844885732,184,10,receive,18841678197,3207535
18844886123,64,12,receive,18841678270,3207853
18844886506,28,16,receive,18841678595,3207911
18844886879,18,1,receive,18841679593,3207286
18844887252,68,2,receive,18841641526,3245726
18844887722,134,11,receive,18841646934,3240788
18844931537,6,9,receive,18841680190,3251347
18844931927,36,12,receive,18841680327,3251600
18844932344,198,1,receive,18841680913,3251431
18844932728,112,10,receive,18841681015,3251713
18844933144,34,13,receive,18841681236,3251908
18844933513,26,14,receive,18841681561,3251952
18844933873,10,6,receive,18841681583,3252290
18844934282,132,12,receive,18841681666,3252616
18844934668,36,13,receive,18841683581,3251087
18844935049,100,5,receive,18841683659,3251390
18844935429,54,10,receive,18841683696,3251733
18844935802,8,8,receive,18841684301,3251501
18844936196,162,11,receive,18841684373,3251823
18844985007,200,3,receive,18841478907,3506100
18844985500,126,7,receive,18841684580,3300920
18844985928,98,8,receive,18841684736,3301192
18844986331,140,21,receive,18841685036,3301295
18844986709,32,1,receive,18841685113,3301596
18844987092,38,13,receive,18841685203,3301889
18844987569,114,12,receive,18841685903,3301666
18844987953,190,6,receive,18841685999,3301954
18844988340,80,15,receive,18841686387,3301953
18844988719,66,7,receive,18841513223,3475496
18844989117,96,20,receive,18841686434,3302683
18844989519,162,12,receive,18841686521,3302998
18844989905,114,13,receive,18841687084,3302821
18844990302,128,10,receive,18841626169,3364133
18845038979,34,14,receive,18841687437,3351542
18845039400,128,11,receive,18841689253,3350147
18845039812,108,2,receive,18841587673,3452139
18845040316,176,3,receive,18841512925,3527391
18845040708,68,3,receive,18841690190,3350518
18845041131,154,15,receive,18841690334,3350797
18845041523,136,12,receive,18841690573,3350950
18845041898,130,5,receive,18841690581,3351317
18845042347,96,21,receive,18841690695,3351652
18845042760,76,19,receive,18841690725,3352035
18845043158,36,14,receive,18841690817,3352341
18845043527,74,4,receive,18841691162,3352365
18845092313,52,7,receive,18841692736,3399577
18845092742,26,15,receive,18841692795,3399947
18845093121,200,4,receive,18841693632,3399489
18845093518,152,4,receive,18841495786,3597732
18845093915,122,14,receive,18841694742,3399173
18845094319,86,13,receive,18841695423,3398896
18845094714,112,11,receive,18841696330,3398384
18845095108,80,16,receive,18841697724,3397384
18845095623,22,4,receive,18841698228,3397395
18845096008,118,20,receive,18841698422,3397586
18845096395,58,2,receive,18841486358,3610037
18845096890,140,22,receive,18841699260,3397630
18845097286,142,8,receive,18841699541,3397745
18845097802,46,13,receive,18841701724,3396078
18845098185,122,15,receive,18841701954,3396231
18845151104,102,10,receive,18841702147,3448957
18845151498,116,9,receive,18841702450,3449048
18845151895,96,22,receive,18841702967,3448928
18845152306,112,12,receive,18841703541,3448765
18845152691,194,5,receive,18841703772,3448919
18845153063,126,8,receive,18841703854,3449209
18845153435,10,7,receive,18841704865,3448570
18845153812,138,9,receive,18841704952,3448860
18845154217,80,17,receive,18841704966,3449251
18845154585,82,6,receive,18841650553,3504032
18845154940,76,20,receive,18841705945,3448995
18845155307,36,15,receive,18841706053,3449254
18845210529,190,7,receive,18841706312,3504217
18845211262,158,16,receive,18841707381,3503881
18845211662,8,9,receive,18841707674,3503988
18845212049,132,13,receive,18841707996,3504053
18845212428,134,12,receive,18841708339,3504089
18845212804,114,14,receive,18841708365,3504439
18845213207,150,13,receive,18841708481,3504726
18845213646,42,12,receive,18841709497,3504149
18845214094,42,13,receive,18841709631,3504463
18845214627,198,2,receive,18841710279,3504348
18845264830,40,10,receive,18841601946,3662884
18845265318,190,8,receive,18841710529,3554789
18845265721,2,6,receive,18841609282,3656439
18845266139,106,11,receive,18841711902,3554237
18845266549,98,9,receive,18841712041,3554508
18845266939,28,17,receive,18841712963,3553976
18845267398,68,4,receive,18841713591,3553807
18845267781,42,14,receive,18841713797,3553984
18845268161,98,10,receive,18841714181,3553980
18845268854,188,6,receive,18841546511,3722343
18845269473,60,6,receive,18841714757,3554716
18845317032,140,23,receive,18841715378,3601654
18845317439,52,8,receive,18841715162,3602277
18845317839,10,8,receive,18841717063,3600776
18845318216,120,17,receive,18841717389,3600827
18845318591,158,17,receive,18841717525,3601066
18845318990,134,13,receive,18841717575,3601415
18845319387,10,9,receive,18841719213,3600174
18845319777,28,18,receive,18841719195,3600582
18845320174,142,9,receive,18841719787,3600387
18845320550,106,12,receive,18841720126,3600424
18845320965,12,5,receive,18841561216,3759749
18845321367,188,7,receive,18841720410,3600957
18845377058,32,2,receive,18841720548,3656510
18845377466,164,8,receive,18841601252,3776214
18845377920,36,16,receive,18841721332,3656588
18845378347,172,5,receive,18841569369,3808978
18845378733,86,14,receive,18841722727,3656006
18845379118,152,5,receive,18841722927,3656191
18845379519,142,10,receive,18841723022,3656497
18845379937,54,11,receive,18841723017,3656920
18845380330,64,13,receive,18841723318,3657012
18845380704,160,2,receive,18841678903,3701801
18845381286,184,11,receive,18841723641,3657645
18845381673,170,5,receive,18841723934,3657739
18845382103,88,5,receive,18841544227,3837876
18845382601,114,15,receive,18841725565,3657036
18845441159,158,18,receive,18841725698,3715461
18845441564,106,13,receive,18841726329,3715235
18845442003,130,6,receive,18841726878,3715125
18845442410,46,14,receive,18841727030,3715380
18845442831,100,6,receive,18841727108,3715723
18845443205,38,14,receive,18841727476,3715729
18845443575,136,13,receive,18841727885,3715690
18845443948,130,7,receive,18841728050,3715898
18845444347,128,12,receive,18841728580,3715767
18845444751,154,16,receive,18841728638,3716113
18845445130,120,18,receive,18841729573,3715557
18845445499,182,2,receive,18841597197,3848302
18845493334,72,1,receive,18841730066,3763268
18845493730,66,8,receive,18841730855,3762875
18845494125,8,10,receive,18841730015,3764110
18845494608,60,7,receive,18841732018,3762590
18845495077,70,13,receive,18841613963,3881114
18845495463,28,19,receive,18841733323,3762140
18845495847,94,6,receive,18841636130,3859717
18845496256,22,5,receive,18841733772,3762484
18845496655,184,12,receive,18841733892,3762763
18845497037,84,10,receive,18841601736,3895301
18845497411,118,21,receive,18841734778,3762633
18845497781,34,15,receive,18841734828,3762953
18845550192,152,6,receive,18841735194,3814998
18845550710,134,14,receive,18841735797,3814913
18845551109,60,8,receive,18841736232,3814877
18845551499,68,5,receive,18841736824,3814675
18845551882,110,3,receive,18841486367,4065515
18845552343,74,5,receive,18841737428,3814915
18845552723,102,11,receive,18841737553,3815170
18845553422,64,14,receive,18841737585,3815837
18845553912,52,9,receive,18841737705,3816207
18845554370,84,11,receive,18841738132,3816238
18845554755,134,15,receive,18841738972,3815783
18845555197,92,8,receive,18841535245,4019952
18845555606,74,6,receive,18841740622,3814984
18845608224,74,7,receive,18841740775,3867449
18845608637,38,15,receive,18841741098,3867539
18845609030,50,2,receive,18841428319,4180711
18845609451,96,23,receive,18841741323,3868128
18845609878,194,6,receive,18841741433,3868445
18845610324,98,11,receive,18841741440,3868884
18845610719,198,3,receive,18841741593,3869126
18845611107,120,19,receive,18841741782,3869325
18845611525,122,16,receive,18841742237,3869288
18845611922,80,18,receive,18841742320,3869602
18845612313,184,13,receive,18841743119,3869194
18845612986,56,9,receive,18841646408,3966578
18845666605,26,16,receive,18841744425,3922180
18845667109,128,13,receive,18841744784,3922325
18845667533,142,11,receive,18841746438,3921095
18845667938,170,6,receive,18841747203,3920735
18845668320,182,3,receive,18841747346,3920974
18845668700,68,7,receive,18841798193,3870507
18845669119,34,18,receive,18841798535,3870584
18845669493,42,17,receive,18841798872,3870621
18845669864,100,8,receive,18841799816,3870048
18845670258,170,9,receive,18841799852,3870406
18845670632,196,2,receive,18841600169,4070463
18845671070,78,8,receive,18841636304,4034766
18845671456,96,25,receive,18841800192,3871264
18845671831,68,8,receive,18841800365,3871466
18845672200,166,7,receive,18841676492,3995708
18845729249,66,11,receive,18841800892,3928357
18845729812,108,3,receive,18841727853,4001959
18845730861,182,5,receive,18841802918,3927943
18845731547,180,9,receive,18841804194,3927353
18845731972,144,9,receive,18841805106,3926866
18845732361,116,12,receive,18841805200,3927161
18845732736,144,10,receive,18841805309,3927427
18845733105,136,16,receive,18841805682,3927423
18845733476,42,18,receive,18841806058,3927418
18845791863,86,16,receive,18841807179,3984684
18845792268,114,17,receive,18841807187,3985081
18845792675,22,9,receive,18841807576,3985099
18845793060,42,19,receive,18841809249,3983811
18845793425,130,9,receive,18841809656,3983769
18845793786,122,18,receive,18841811199,3982587
18845794151,186,12,receive,18841811246,3982905
18845794546,100,9,receive,18841811997,3982549
18845794936,118,25,receive,18841812705,3982231
18845795307,116,13,receive,18841813388,3981919
18845795733,56,12,receive,18841813357,3982376
18845796146,96,26,receive,18841813572,3982574
18845796548,152,8,receive,18841813765,3982783
18845856712,170,10,receive,18841814060,4042652
18845857261,34,19,receive,18841814778,4042483
18845857748,198,5,receive,18841815174,4042574
18845858239,162,13,receive,18841727344,4130895
18845858622,74,9,receive,18841815425,4043197
18845858999,140,27,receive,18841815698,4043301
18845859366,56,13,receive,18841816624,4042742
18845859788,90,4,receive,18841817159,4042629
18845860204,140,28,receive,18841817899,4042305
18845860587,8,13,receive,18841818877,4041710
18845860949,126,9,receive,18841739219,4121730
18845861309,140,29,receive,18841820599,4040710
18845914272,158,20,receive,18841822474,4091798
18845914729,28,21,receive,18841822963,4091766
18845916112,78,9,receive,18841824553,4091559
18845916624,104,7,receive,18841699199,4217425
18845917482,104,8,receive,18841825131,4092351
18845917962,68,9,receive,18841825431,4092531
18845918328,118,26,receive,18841825919,4092409
18845918692,24,10,receive,18841641426,4277266
18845967386,110,8,receive,18841826548,4140838
18845967773,20,5,receive,18841591400,4376373
18845968170,34,20,receive,18841828009,4140161
18845968546,126,10,receive,18841828263,4140283
18845968963,180,10,receive,18841828478,4140485
18845969341,116,14,receive,18841828612,4140729
18845969766,4,8,receive,18841829214,4140552
18845970250,58,3,receive,18841742824,4227426
18845970626,68,10,receive,18841829569,4141057
18845970998,150,14,receive,18841717712,4253286
18845971364,100,10,receive,18841831174,4140190
18845971727,86,17,receive,18841831453,4140274
18845972110,96,27,receive,18841831797,4140313
18846024942,22,10,receive,18841832777,4192165
18846025328,78,10,receive,18841832985,4192343
18846025710,8,14,receive,18841833097,4192613
18846026102,182,6,receive,18841833287,4192815
18846026496,186,13,receive,18841833436,4193060
18846026914,22,11,receive,18841834911,4192003
18846027291,120,24,receive,18841835026,4192265
18846027747,136,17,receive,18841835073,4192674
18846028138,16,7,receive,18841797629,4230509
18846028573,36,19,receive,18841835547,4193026
18846029027,36,20,receive,18841836746,4192281
18846029400,76,23,receive,18841837003,4192397
18846029771,22,12,receive,18841837036,4192735
18846030160,162,14,receive,18841838645,4191515
18846084466,130,10,receive,18841839909,4244557
18846084872,200,5,receive,18841716123,4368749
18846085247,24,11,receive,18841841688,4243559
18846085610,96,28,receive,18841842009,4243601
18846085975,136,18,receive,18841842201,4243774
18846086416,88,8,receive,18841842303,4244113
18846086782,80,22,receive,18841842369,4244413
18846087143,132,14,receive,18841742394,4344749
18846087505,110,9,receive,18841843747,4243758
18846087873,78,11,receive,18841845258,4242615
18846158957,42,20,receive,18841846483,4312474
18846159377,24,12,receive,18841846908,4312469
18846159740,52,12,receive,18841847466,4312274
18846160128,106,14,receive,18841775725,4384403
18846160489,16,8,receive,18841848527,4311962
18846225299,12,6,receive,18841758587,4466712
18846225961,56,14,receive,18841851139,4374822
18846226451,168,11,receive,18841851474,4374977
18846226858,150,15,receive,18841852376,4374482
18846227240,18,2,receive,18841716566,4510674
18846227615,76,24,receive,18841853240,4374375
18846227984,112,13,receive,18841741906,4486078
18846228437,58,4,receive,18841853767,4374670
18846228810,56,15,receive,18841854322,4374488
18846229169,114,18,receive,18841854476,4374693
18846279574,92,9,receive,18841790465,4489109
18846279970,104,9,receive,18841826314,4453656
18846280420,104,10,receive,18841855826,4424594
18846280792,34,21,receive,18841856310,4424482
18846281214,100,11,receive,18841856360,4424854
18846281586,22,13,receive,18841857182,4424404
18846281955,2,7,receive,18841734112,4547843
18846282382,164,9,receive,18841770008,4512374
18846282752,106,15,receive,18841857940,4424812
18846283127,18,3,receive,18841858967,4424160
18846283551,170,11,receive,18841859452,4424099
18846284046,52,13,receive,18841859733,4424313
18846284457,140,30,receive,18841859882,4424575
18846284848,124,7,receive,18841638543,4646305
18846332533,28,22,receive,18841860356,4472177
18846332918,76,25,receive,18841861458,4471460
18846333285,44,7,receive,18841664818,4668467
18846333649,180,11,receive,18841861815,4471834
18846334016,22,14,receive,18841862321,4471695
18846334446,90,5,receive,18841862532,4471914
18846334807,114,19,receive,18841862664,4472143
18846336273,162,15,receive,18841862907,4473366
18846336956,70,14,receive,18841741386,4595570
18846385096,56,16,receive,18841864536,4520560
18846385503,140,31,receive,18841866056,4519447
18846385885,186,14,receive,18841866754,4519131
18846386249,98,12,receive,18841757659,4628590
18846386606,52,14,receive,18841866993,4519613
18846386964,130,11,receive,18841867196,4519768
18846387485,186,15,receive,18841867934,4519551
18846387868,176,4,receive,18841726486,4661382
18846388239,182,7,receive,18841868675,4519564
18846388604,126,11,receive,18841869873,4518731
18846388969,194,7,receive,18841779767,4609202
18846389403,14,12,receive,18841677104,4712299
18846389843,4,9,receive,18841870013,4519830
18846438888,36,21,receive,18841870187,4568701
18846439352,118,27,receive,18841870297,4569055
18846440133,68,11,receive,18841870850,4569283
18846441023,92,10,receive,18841871691,4569332
18846441444,178,10,receive,18841769258,4672186
18846441824,104,11,receive,18841873111,4568713
18846442574,162,16,receive,18841873247,4569327
18846487673,120,25,receive,18841873381,4614292
18846488085,104,12,receive,18841876316,4611769
18846488463,100,12,receive,18841876909,4611554
18846488889,116,15,receive,18841878871,4610018
18846489256,56,17,receive,18841879822,4609434
18846489753,132,15,receive,18841880793,4608960
18846490458,114,20,receive,18841880878,4609580
18846491187,176,5,receive,18841882205,4608982
18846491946,64,15,receive,18841741873,4750073
18846492449,182,8,receive,18841883918,4608531
18846492865,6,10,receive,18841730601,4762264
18846536746,148,3,receive,18841813422,4723324
18846537138,34,22,receive,18841885618,4651520
18846537542,54,14,receive,18841801463,4736079
18846538034,126,12,receive,18841886251,4651783
18846538408,36,22,receive,18841886464,4651944
18846538881,6,11,receive,18841885753,4653128
18846539249,100,13,receive,18841888136,4651113
18846539616,148,4,receive,18841888404,4651212
18846540062,88,9,receive,18841889644,4650418
18846540448,52,15,receive,18841890310,4650138
18846540824,96,29,receive,18841890307,4650517
18846541266,68,12,receive,18841892079,4649187
18846541636,100,14,receive,18841892273,4649363
18846589812,62,2,receive,18841595400,4994412
18846590268,78,12,receive,18841892579,4697689
18846590639,114,21,receive,18841893077,4697562
18846591075,168,10,receive,18841805096,4785979
18846591450,52,16,receive,18841893528,4697922
18846591878,100,15,receive,18841894435,4697443
18846592245,42,21,receive,18841895933,4696312
18846593302,32,3,receive,18841744069,4849233
18846593684,170,12,receive,18841896667,4697017
18846594055,168,12,receive,18841896843,4697212
18846594472,172,6,receive,18841763313,4831159
18846654098,150,16,receive,18841898735,4755363
18846654502,138,10,receive,18841743273,4911229
18846654899,16,9,receive,18841898916,4755983
18846655344,180,12,receive,18841899050,4756294
18846655750,192,11,receive,18841761948,4893802
18846659010,12,7,receive,18841900457,4758553
18846659483,164,10,receive,18841900596,4758887
18846659870,90,6,receive,18841893144,4766726
18846705735,58,5,receive,18841902202,4803533
18846706123,164,11,receive,18841902772,4803351
18846706491,132,16,receive,18841904107,4802384
18846706859,130,12,receive,18841904524,4802335
18846707235,162,17,receive,18841905507,4801728
18846707664,22,15,receive,18841905643,4802021
18846708032,162,18,receive,18841906681,4801351
18846708397,100,16,receive,18841907616,4800781
18846708762,2,8,receive,18841907671,4801091
18846709293,144,11,receive,18841810524,4898769
18846709727,178,11,receive,18841881295,4828432
18846710168,4,10,receive,18841909463,4800705
18846710702,158,21,receive,18841866882,4843820
18846751036,28,23,receive,18841910751,4840285
18846751413,174,9,receive,18841789335,4962078
18846752673,172,7,receive,18841912888,4839785
18846753051,196,3,receive,18841826348,4926703
18846753423,186,16,receive,18841914304,4839119
18846753803,62,3,receive,18841914678,4839125
18846754204,62,4,receive,18841914806,4839398
18846754593,138,11,receive,18841915164,4839429
18846754961,52,17,receive,18841915836,4839125
18846755332,68,13,receive,18841916290,4839042
18846755699,140,32,receive,18841916447,4839252
18846800674,2,9,receive,18841916839,4883835
18846801053,34,23,receive,18841910912,4890141
18846801443,8,15,receive,18841881443,4920000
18846801901,54,15,receive,18841917542,4884359
18846802265,12,8,receive,18841917746,4884519
18846802630,82,8,receive,18841804222,4998408
18846802995,146,13,receive,18841690013,5112982
18846803365,184,14,receive,18841759384,5043981
18846803777,186,17,receive,18841920480,4883297
18846804886,104,13,receive,18841921651,4883235
18846805418,88,10,receive,18841921925,4883493
18846805898,154,17,receive,18841779115,5026783
18846806274,22,16,receive,18841923861,4882413
18846846206,28,24,receive,18841924003,4922203
18846846804,164,12,receive,18841924079,4922725
18846847203,170,13,receive,18841925074,4922129
18846847590,28,25,receive,18841925189,4922401
18846848829,66,12,receive,18841805163,5043666
18846849749,38,16,receive,18841767319,5082430
18846850176,48,16,receive,18841839857,5010319
18846850664,68,14,receive,18841928502,4922162
18846851033,6,12,receive,18841928914,4922119
18846851399,62,5,receive,18841928968,4922431
18846851765,134,17,receive,18841806614,5045151
18846852137,90,7,receive,18841929458,4922679
18846852575,112,14,receive,18841894212,4958363
18846894891,126,13,receive,18841932687,4962204
18846895303,78,13,receive,18841932952,4962351
18846895762,38,17,receive,18841933099,4962663
18846896151,130,13,receive,18841933824,4962327
18846896547,22,17,receive,18841934048,4962499
18846897781,140,33,receive,18841934679,4963102
18846898301,100,17,receive,18841934846,4963455
18846898692,142,13,receive,18841802956,5095736
18846899075,150,17,receive,18841935325,4963750
18846899519,28,26,receive,18841935378,4964141
18846899960,180,13,receive,18841935399,4964561
18846942985,100,18,receive,18841937017,5005968
18846943376,42,22,receive,18841937219,5006157
18846943746,148,5,receive,18841938793,5004953
18846944140,12,9,receive,18841939167,5004973
18846944756,22,18,receive,18841939231,5005525
18846945174,112,15,receive,18841934229,5010945
18846945544,146,14,receive,18841939530,5006014
18846945911,190,11,receive,18841819219,5126692
18846946335,44,8,receive,18841889027,5057308
18846946707,52,18,receive,18841942063,5004644
18846947071,76,26,receive,18841887689,5059382
18846947435,38,18,receive,18841943352,5004083
18846947855,186,18,receive,18841943761,5004094
18846992753,140,34,receive,18841943857,5048896
18846993166,162,19,receive,18841944112,5049054
18846993554,6,13,receive,18841944127,5049427
18846993953,30,12,receive,18841821043,5172910
18847042635,50,3,receive,18841784636,5257999
18847043043,188,8,receive,18841757738,5285305
18847043472,72,3,receive,18841785908,5257564
18847043875,6,14,receive,18841946277,5097598
18847044242,16,10,receive,18841947390,5096852
18847044808,128,14,receive,18841786169,5258639
18847045297,188,9,receive,18841947552,5097745
18847045661,26,17,receive,18841773744,5271917
18847046110,116,16,receive,18841904096,5142014
18847046476,172,8,receive,18841948306,5098170
18847046857,70,15,receive,18841883243,5163614
18847047237,98,13,receive,18841917288,5129949
18847087850,88,11,receive,18841950132,5137718
18847088315,52,19,receive,18841951238,5137077
18847090638,4,11,receive,18841951826,5138812
18847091069,60,10,receive,18841806130,5284939
18847091475,130,14,receive,18841953077,5138398
18847091861,132,17,receive,18841954537,5137324
18847134402,62,6,receive,18841956192,5178210
18847134819,60,11,receive,18841956270,5178549
18847135215,172,9,receive,18841957488,5177727
18847135613,196,4,receive,18841957891,5177722
18847136003,14,13,receive,18841883395,5252608
18847136496,174,10,receive,18841958425,5178071
18847136889,16,11,receive,18841958671,5178218
18847137266,186,19,receive,18841957004,5180262
18847137643,146,15,receive,18841959733,5177910
18847138017,104,14,receive,18841959906,5178111
18847138508,198,6,receive,18841848604,5289904
18847138877,124,8,receive,18841907816,5231061
18847139232,130,15,receive,18841962226,5177006
18847184909,24,13,receive,18841874235,5310674
18847185316,138,12,receive,18841962676,5222640
18847185706,170,14,receive,18841963328,5222378
18847186067,112,16,receive,18841963720,5222347
18847186506,48,17,receive,18841964016,5222490
18847186875,68,15,receive,18841949742,5237133
18847187237,164,13,receive,18841965431,5221806
18847187905,64,16,receive,18841887714,5300191
18847188395,172,10,receive,18841967672,5220723
18847188834,52,20,receive,18841968422,5220412
18847189318,40,11,receive,18841737806,5451512
18847189803,52,21,receive,18841969590,5220213
18847237217,152,9,receive,18841862166,5375051
18847237636,4,12,receive,18841970998,5266638
18847238045,88,12,receive,18841972420,5265625
18847238491,126,14,receive,18841973129,5265362
18847238874,174,11,receive,18841973682,5265192
18847239323,28,27,receive,18841973737,5265586
18847239692,64,17,receive,18841969402,5270290
18847240086,174,12,receive,18841973807,5266279
18847240455,16,12,receive,18841973907,5266548
18847240864,40,12,receive,18841971741,5269123
18847241266,180,14,receive,18841975754,5265512
18847241634,176,6,receive,18841923452,5318182
18847242026,186,20,receive,18841975955,5266071
18847242432,152,10,receive,18841976026,5266406
18847284161,136,19,receive,18841976058,5308103
18847284565,22,19,receive,18841976516,5308049
18847284931,24,14,receive,18841976500,5308431
18847285289,78,14,receive,18841977426,5307863
18847285650,86,18,receive,18841861644,5424006
18847286285,10,11,receive,18841798950,5487335
18847286714,128,15,receive,18841963775,5322939
18847287091,126,15,receive,18841979385,5307706
18847287578,90,8,receive,18841979739,5307839
18847288027,156,9,receive,18841813878,5474149
18847288403,108,4,receive,18841823105,5465298
18847288771,68,16,receive,18841980359,5308412
18847289130,12,10,receive,18841980627,5308503
18847289489,44,9,receive,18841980989,5308500
18847289950,148,6,receive,18841981399,5308551
18847290329,114,22,receive,18841917464,5372865
18847336141,46,17,receive,18841832161,5503980
18847336561,190,12,receive,18841982763,5353798
18847337265,94,7,receive,18841774087,5563178
18847337674,106,16,receive,18841894231,5443443
18847338039,188,10,receive,18841984118,5353921
18847338401,36,23,receive,18841913838,5424563
18847338760,190,13,receive,18841985915,5352845
18847339259,48,18,receive,18841986280,5352979
18847340056,6,15,receive,18841986517,5353539
18847340627,90,9,receive,18841986924,5353703
18847377191,138,13,receive,18841986964,5390227
18847377633,132,18,receive,18841987019,5390614
18847378011,100,19,receive,18841987357,5390654
18847378386,50,4,receive,18841987374,5391012
18847378753,42,23,receive,18841987589,5391164
18847379117,146,16,receive,18841987946,5391171
18847379498,94,8,receive,18841987959,5391539
18847379905,120,26,receive,18841903620,5476285
18847380345,4,13,receive,18841989223,5391122
18847380728,134,18,receive,18841944476,5436252
18847381109,150,18,receive,18841976805,5404304
18847381513,40,13,receive,18841990873,5390640
18847381896,140,35,receive,18841991214,5390682
18847394412,160,3,receive,18841743791,5650621
18847397199,84,12,receive,18841759423,5637776
18847399166,84,13,receive,18841992797,5406369
18847401098,162,20,receive,18841985481,5415617
18847403055,186,21,receive,18841993217,5409838
18847405269,140,36,receive,18841993442,5411827
18847407600,80,23,receive,18841878655,5528945
18847409704,108,5,receive,18841995215,5414489
18847412102,24,15,receive,18841995226,5416876
18847414120,152,11,receive,18841995355,5418765
18847416498,124,9,receive,18841995498,5421000
18847419262,90,10,receive,18841996109,5423153
18847421303,198,7,receive,18841973122,5448181
18847423608,100,20,receive,18841996537,5427071
18847426044,172,11,receive,18841996887,5429157
18847428585,94,9,receive,18841997204,5431381
18847436386,102,13,receive,18841828324,5608062
18847438944,60,12,receive,18841998629,5440315
18847440577,50,5,receive,18841999588,5440989
18847442992,68,17,receive,18842001610,5441382
18847445096,162,21,receive,18842002017,5443079
18847447945,174,13,receive,18842002047,5445898
18847450533,160,4,receive,18842002156,5448377
18847453969,196,5,receive,18842003331,5450638
18847456121,94,10,receive,18842003381,5452740
18847459424,104,15,receive,18842005314,5454110
18847460996,62,7,receive,18842005510,5455486
18847464228,38,19,receive,18841962549,5501679
18847467336,186,22,receive,18842006460,5460876
18847470277,20,6,receive,18841876902,5593375
18847472473,94,11,receive,18842009612,5462861
18847475161,50,6,receive,18842009819,5465342
18847477176,4,14,receive,18842010095,5467081
18847479986,132,19,receive,18842011272,5468714
18847482696,4,15,receive,18842011345,5471351
18847484896,84,14,receive,18842011960,5472936
18847487998,2,10,receive,18841963236,5524762
18847490502,78,15,receive,18842012766,5477736
18847492869,72,4,receive,18841959900,5532969
18847494907,112,17,receive,18842013105,5481802
18847497527,146,17,receive,18842013241,5484286
18847499501,122,19,receive,18841857583,5641918
18847501444,62,8,receive,18842014702,5486742
18847503636,172,12,receive,18842017098,5486538
18847505652,44,10,receive,18842017745,5487907
18847507747,72,5,receive,18842018272,5489475
18847510188,188,11,receive,18842018314,5491874
18847511869,16,13,receive,18842019359,5492510
18847514016,72,6,receive,18842019470,5494546
18847516090,110,10,receive,18841882018,5634072
18847523450,52,22,receive,18842019979,5503471
18847525203,26,18,receive,18841981500,5543703
18847527214,60,13,receive,18842020905,5506309
18847529285,112,18,receive,18842021300,5507985
18847531251,124,10,receive,18842021845,5509406
18847543362,176,7,receive,18842023241,5520121
18847544556,180,15,receive,18841992620,5551936
18847546085,184,15,receive,18841949221,5596864
18847548053,148,7,receive,18842026790,5521263
18847557864,146,18,receive,18842027440,5530424
18847559731,30,13,receive,18841978635,5581096
18847561712,34,24,receive,18841948481,5613231
18847564625,44,11,receive,18842028953,5535672
18847573602,40,14,receive,18842029305,5544297
18847588080,188,12,receive,18842029520,5558560
18847592345,152,12,receive,18842029700,5562645
18847593567,12,11,receive,18842030011,5563556
18847594725,100,21,receive,18842030833,5563892
18847595954,140,37,receive,18842030863,5565091
18847596978,48,19,receive,18842014582,5582396
18847599609,192,12,receive,18841919388,5680221
18847621308,148,8,receive,18842034028,5587280
18847621770,176,8,receive,18842034494,5587276
18847622244,110,11,receive,18842035224,5587020
18847622869,94,12,receive,18842035968,5586901
18847623289,90,11,receive,18842036368,5586921
18847623731,172,13,receive,18842037236,5586495
18847624337,82,9,receive,18841955472,5668865
18847625002,92,11,receive,18841886940,5738062
18847625572,50,7,receive,18842039188,5586384
18847626026,40,15,receive,18842039545,5586481
18847630028,4,16,receive,18842039619,5590409
18847630417,64,18,receive,18842023171,5607246
18847671927,152,13,receive,18842039860,5632067
18847672419,78,16,receive,18842040012,5632407
18847672867,178,12,receive,18841959571,5713296
18847673300,74,10,receive,18841831719,5841581
18847673709,62,9,receive,18842040972,5632737
18847674103,46,18,receive,18842022205,5651898
18847674495,146,19,receive,18842041619,5632876
18847674875,20,7,receive,18842043029,5631846
18847675259,124,11,receive,18842043101,5632158
18847675668,102,14,receive,18842045763,5629905
18847676517,178,13,receive,18842046481,5630036
18847677427,10,12,receive,18842012552,5664875
18847677877,196,6,receive,18842046828,5631049
18847678446,172,14,receive,18842047380,5631066
18847681653,90,12,receive,18842047580,5634073
18847714801,86,19,receive,18842016336,5698465
18847717089,192,13,receive,18842048999,5668090
18847719525,44,12,receive,18842049152,5670373
18847720875,194,8,receive,18841905352,5815523
18847723866,78,17,receive,18842050009,5673857
18847726499,60,14,receive,18842050166,5676333
18847730118,176,10,receive,18842060906,5669212
18847731781,164,14,receive,18841982610,5749171
18847734686,162,22,receive,18842010187,5724499
18847737122,114,23,receive,18842029271,5707851
18847739689,182,9,receive,18841929410,5810279
18847744855,124,12,receive,18842063318,5681537
18847747739,40,16,receive,18842063880,5683859
18847749742,56,18,receive,18841917436,5832306
18847751908,60,15,receive,18842065425,5686483
18847756683,110,12,receive,18842065508,5691175
18847759275,80,24,receive,18842038973,5720302
18847762340,192,14,receive,18842066252,5696088
18847763548,112,20,receive,18842067889,5695659
18847765527,120,27,receive,18842015735,5749792
18847773475,194,9,receive,18842069260,5704215
18847775628,166,8,receive,18841839168,5936460
18847779262,164,15,receive,18842106549,5672713
18847781210,46,20,receive,18842185891,5595319
18847782430,84,16,receive,18842138378,5644052
18847785775,184,17,receive,18842159531,5626244
18847800157,46,21,receive,18842191952,5608205
18847802912,50,12,receive,18842192940,5609972
18847807627,142,15,receive,18842118570,5689057
18847810904,68,20,receive,18842191349,5619555
18847815326,46,22,receive,18842194088,5621238
18847817971,14,15,receive,18842195627,5622344
18847822030,144,13,receive,18842102520,5719510
18847823672,132,20,receive,18842039625,5784047
18847825827,140,39,receive,18842148794,5677033
18847830510,58,9,receive,18842165789,5664721
18847831817,34,27,receive,18842226227,5605590
18847833691,136,23,receive,18842193681,5640010
18847835944,46,23,receive,18842227686,5608258
18847837952,194,12,receive,18842235773,5602179
18847851723,122,23,receive,18842213833,5637890
18847854089,60,17,receive,18842097984,5756105
18847856481,42,26,receive,18842209178,5647303
18847859242,30,16,receive,18842218738,5640504
18847920644,10,15,receive,18842232857,5687787
18847921327,40,19,receive,18842236607,5684720
18847921769,182,13,receive,18842243721,5678048
18847922143,110,17,receive,18842236010,5686133
18847922579,104,20,receive,18842307520,5615059
18847922947,94,17,receive,18842305708,5617239
18847923312,116,22,receive,18842286818,5636494
18847923679,104,21,receive,18842317928,5605751
18847924108,174,17,receive,18842267264,5656844
18847924552,164,17,receive,18842289630,5634922
18847924917,190,16,receive,18842259803,5665114
18847925284,70,21,receive,18842312195,5613089
18847925654,180,20,receive,18842270909,5654745
18847926018,130,22,receive,18842282903,5643115
18847950260,162,27,receive,18842280499,5669761
18847950706,20,13,receive,18842300952,5649754
18847951486,76,31,receive,18842302007,5649479
18847954169,48,23,receive,18842317728,5636441
18847955752,156,16,receive,18842320081,5635671
18847956903,14,18,receive,18842309813,5647090
18847958669,142,18,receive,18842343903,5614766
18847960899,102,23,receive,18842333052,5627847
18847964143,136,25,receive,18842329184,5634959
18847966160,80,28,receive,18842327585,5638575
18847968977,186,28,receive,18842317260,5651717
18847971397,30,18,receive,18842335957,5635440
18847973559,58,12,receive,18842324303,5649256
18847977728,108,10,receive,18842318723,5659005
18847983153,46,25,receive,18842346897,5636256
18847985172,56,25,receive,18842382703,5602469
18847987113,200,10,receive,18842376776,5610337
18847990262,86,26,receive,18842377350,5612912
18847991854,142,19,receive,18842366121,5625733
18847994142,164,18,receive,18842342805,5651337
18847996159,188,19,receive,18842386992,5609167
18848008560,128,24,receive,18842375653,5632907
18848010643,48,24,receive,18842356487,5654156
18848013391,106,22,receive,18842400386,5613005
18848016576,62,18,receive,18842365923,5650653
18848019044,96,36,receive,18842384795,5634249
18848020991,148,15,receive,18842403130,5617861
18848024809,136,26,receive,18842376619,5648190
18848027957,68,24,receive,18842370923,5657034
18848030358,30,19,receive,18842369032,5661326
18848032712,18,9,receive,18842331705,5701007
18848036287,8,22,receive,18842420426,5615861
18848044615,148,16,receive,18842455502,5589113
18848046859,20,16,receive,18842455747,5591112
18848048563,64,24,receive,18842420222,5628341
18848051495,88,19,receive,18842454109,5597386
18848053508,168,21,receive,18842425157,5628351
18848055548,36,33,receive,18842445596,5609952
18848058520,78,23,receive,18842411580,5646940
18848059626,122,27,receive,18842446774,5612852
18848061326,116,25,receive,18842430655,5630671
18848063586,30,20,receive,18842437063,5626523
18848065900,38,27,receive,18842431329,5634571
18848067500,136,27,receive,18842414428,5653072
18848069920,8,23,receive,18842495667,5574253
18848072507,88,20,receive,18842503586,5568921
18848075242,92,18,receive,18842500435,5574807
18848077754,158,31,receive,18842487147,5590607
18848080170,70,25,receive,18842504409,5575761
18848084046,198,14,receive,18842475385,5608661
18848087050,122,28,receive,18842503289,5583761
18848099544,22,29,receive,18842481804,5617740
18848099949,88,21,receive,18842508829,5591120
18848100357,30,21,receive,18842468122,5632235
18848100731,24,28,receive,18842510462,5590269
18848101100,136,28,receive,18842482057,5619043
18848101469,184,23,receive,18842533833,5567636
18848101917,6,24,receive,18842534393,5567524
18848102297,162,32,receive,18842507203,5595094
18848102684,20,18,receive,18842512358,5590326
18848103078,146,26,receive,18842545758,5557320
18848103450,106,25,receive,18842528552,5574898
18848103909,40,26,receive,18842503195,5600714
18848143387,22,30,receive,18842547090,5596297
18848143890,2,20,receive,18842531582,5612308
18848144469,134,28,receive,18842517735,5626734
18848144859,64,26,receive,18842535917,5608942
18848145227,166,20,receive,18842511891,5633336
18848145591,98,18,receive,18842490285,5655306
18848146033,166,21,receive,18842590212,5555821
18848146420,104,26,receive,18842588392,5558028
18848146900,20,19,receive,18842600860,5546040
18848147370,126,26,receive,18842556639,5590731
18848172015,140,47,receive,18842569360,5602655
18848172483,6,25,receive,18842597493,5574990
18848172856,162,33,receive,18842596501,5576355
18848173213,18,12,receive,18842581769,5591444
18848173573,64,27,receive,18842583707,5589866
18848173936,146,27,receive,18842589459,5584477
18848174367,174,22,receive,18842606264,5568103
18848174819,60,26,receive,18842567096,5607723
18848175198,60,27,receive,18842658467,5516731
18848175609,134,30,receive,18842620286,5555323
18848176018,2,22,receive,18842616782,5559236
18848176451,64,28,receive,18842654000,5522451
18848192212,164,21,receive,18842587207,5605005
18848193339,100,31,receive,18842647292,5546047
18848194960,146,28,receive,18842625820,5569140
18848196282,126,27,receive,18842608159,5588123
18848197746,98,20,receive,18842613748,5583998
18848200294,152,24,receive,18842630122,5570172
18848201820,16,23,receive,18842637348,5564472
18848204303,6,26,receive,18842646394,5557909
18848207554,158,35,receive,18842619900,5587654
18848209586,4,26,receive,18842619339,5590247
18848212074,158,36,receive,18842675987,5536087
18848213963,100,32,receive,18842668662,5545301
18848216112,2,23,receive,18842685183,5530929
18848219318,134,31,receive,18842687055,5532263
18848220381,90,27,receive,18842689845,5530536
18848220746,152,25,receive,18842705689,5515057
18848221140,108,18,receive,18842712369,5508771
18848221513,88,24,receive,18842662809,5558704
18848221876,4,27,receive,18842695564,5526312
18848222242,178,25,receive,18842704018,5518224
18848222604,92,24,receive,18842713484,5509120
18848222987,12,26,receive,18842713010,5509977
18848223394,168,26,receive,18842704582,5518812
18848223776,66,24,receive,18842727107,5496669
18848224148,26,31,receive,18842737978,5486170
18848224595,178,26,receive,18842732213,5492382
18848268071,152,27,receive,18842767125,5500946
18848268476,196,20,receive,18842725148,5543328
18848268856,186,37,receive,18842733514,5535342
18848269229,130,31,receive,18842754317,5514912
18848269602,168,27,receive,18842731242,5538360
18848270059,134,32,receive,18842752931,5517128
18848270495,2,24,receive,18842735739,5534756
18848270958,74,21,receive,18842758327,5512631
18848271471,108,19,receive,18842750007,5521464
18848271955,88,25,receive,18842758891,5513064
18848272434,130,32,receive,18842814562,5457872
18848311545,152,28,receive,18842801506,5510039
18848312281,12,28,receive,18842795957,5516324
18848312713,92,26,receive,18842792874,5519839
18848313110,168,28,receive,18842810722,5502388
18848313476,108,20,receive,18842822162,5491314
18848314011,186,38,receive,18842811094,5502917
18848314381,64,31,receive,18842800671,5513710
18848314790,12,29,receive,18842823877,5490913
18848315176,92,27,receive,18842824085,5491091
18848315545,192,29,receive,18842789898,5525647
18848315900,120,41,receive,18842822160,5493740
18848316274,2,25,receive,18842795976,5520298
18848316776,38,35,receive,18842849564,5467212
18848317215,186,39,receive,18842865497,5451718
18848317592,120,42,receive,18842854002,5463590
18848318052,112,35,receive,18842827347,5490705
18848318437,56,37,receive,18842874268,5444169
18848339961,2,26,receive,18842854308,5485653
18848340660,156,27,receive,18842843567,5497093
18848341553,112,36,receive,18842876132,5465421
18848342352,174,27,receive,18842824859,5517493
18848343197,52,42,receive,18842844599,5498598
18848343978,42,40,receive,18842861906,5482072
18848346020,146,32,receive,18842833813,5512207
18848347636,64,32,receive,18842845995,5501641
18848367504,12,30,receive,18842854255,5513249
18848369475,172,31,receive,18842887879,5481596
18848372786,112,37,receive,18842926471,5446315
18848373911,152,30,receive,18842888097,5485814
18848376810,26,34,receive,18842906543,5470267
18848378483,186,40,receive,18842915501,5462982
18848380543,54,34,receive,18842887515,5493028
18848384961,160,24,receive,18842896851,5488110
18848387963,52,43,receive,18842915538,5472425
18848390417,2,27,receive,18842926596,5463821
18848393716,46,39,receive,18842911860,5481856
18848395244,186,41,receive,18842931922,5463322
18848397251,146,33,receive,18842909284,5487967
18848398632,62,29,receive,18842932992,5465640
18848401579,96,47,receive,18842933916,5467663
18848402728,152,31,receive,18842977835,5424893
18848404720,64,34,receive,18842951341,5453379
18848408254,186,42,receive,18842942326,5465928
18848410709,44,31,receive,18842937781,5472928
18848413208,28,43,receive,18842947229,5465979
18848415255,76,45,receive,18842980564,5434691
18848417809,18,17,receive,18842864079,5553730
18848420116,128,36,receive,18842960846,5459270
18848421033,172,32,receive,18842959220,5461813
18848424046,52,44,receive,18842962799,5461247
18848425729,56,39,receive,18842952359,5473370
18848426983,26,35,receive,18842936787,5490196
18848429317,160,26,receive,18843012127,5417190
18848432151,56,40,receive,18843016171,5415980
18848434512,172,33,receive,18843031330,5403182
18848435817,36,45,receive,18842985759,5450058
18848452752,26,36,receive,18842990263,5462489
18848454336,52,45,receive,18843034438,5419898
18848459150,182,30,receive,18842989375,5469775
18848461143,46,41,receive,18843035152,5425991
18848462405,28,44,receive,18843025260,5437145
18848463669,12,33,receive,18842999700,5463969
18848465346,36,46,receive,18843036801,5428545
18848469982,62,31,receive,18843014770,5455212
18848471234,64,35,receive,18842997566,5473668
18848472369,52,46,receive,18843078033,5394336
18848473961,40,36,receive,18843068444,5405517
18848479115,180,34,receive,18843056742,5422373
18848480811,172,34,receive,18843055088,5425723
18848481970,92,32,receive,18843057735,5424235
18848490849,56,41,receive,18843047661,5443188
18848492468,116,37,receive,18843087877,5404591
18848495047,150,38,receive,18843087215,5407832
18848495792,20,30,receive,18843064920,5430872
18848496969,84,35,receive,18843066766,5430203
18848498130,26,37,receive,18843084685,5413445
18848499794,186,44,receive,18843070992,5428802
18848504270,18,20,receive,18843083733,5420537
18848505495,36,48,receive,18843094445,5411050
18848506704,132,39,receive,18843137810,5368894
18848507983,20,31,receive,18843129120,5378863
18848509575,54,38,receive,18843110836,5398739
18848510707,64,37,receive,18843097492,5413215
18848511848,56,42,receive,18843114747,5397101
18848513051,190,26,receive,18843126082,5386969
18848514198,150,39,receive,18843120551,5393647
18848515656,116,38,receive,18843120906,5394750
18848517295,180,35,receive,18843117379,5399916
18848518457,102,39,receive,18843132068,5386389
18848520104,56,44,receive,18843174238,5345866
18848527232,52,49,receive,18843189865,5337367
18848529195,54,39,receive,18843151574,5377621
18848532196,110,36,receive,18843163336,5368860
18848534304,144,33,receive,18843143000,5391304
18848536375,158,46,receive,18843189647,5346728
18848538370,150,40,receive,18843157376,5380994
18848541445,92,34,receive,18843188375,5353070
18848543146,116,39,receive,18843171549,5371597
18848546441,64,38,receive,18843155360,5391081
18848549861,58,29,receive,18843154978,5394883
18848551204,138,37,receive,18843196285,5354919
18848553406,172,36,receive,18843180737,5372669
18848555480,200,26,receive,18843169596,5385884
18848558073,136,41,receive,18843206997,5351076
18848560789,164,28,receive,18843187868,5372921
18848562742,162,45,receive,18843220508,5342234
18848564850,64,39,receive,18843243742,5321108
18848566849,48,39,receive,18843208558,5358291
18848569772,92,35,receive,18843235254,5334518
18848571411,116,40,receive,18843242487,5328924
18848573475,184,38,receive,18843218698,5354777
18848575382,110,37,receive,18843195517,5379865
18848577899,118,48,receive,18843215568,5362331
18848580239,192,37,receive,18843229044,5351195
18848581816,138,39,receive,18843260546,5321270
18848583855,66,37,receive,18843266967,5316888
18848585832,80,49,receive,18843259071,5326761
18848587758,36,51,receive,18843279603,5308155
18848589673,118,49,receive,18843276506,5313167
18848592831,192,39,receive,18843264591,5328240
18848601138,84,39,receive,18843258640,5342498
18848602023,48,40,receive,18843280073,5321950
18848604004,158,49,receive,18843285102,5318902
18848609685,140,62,receive,18843272264,5337421
18848610910,116,41,receive,18843261352,5349558
18848612502,142,37,receive,18843268580,5343922
18848616610,142,38,receive,18843321161,5295449
18848618761,46,49,receive,18843317574,5301187
18848621532,168,38,receive,18843314204,5307328
18848623179,170,40,receive,18843348351,5274828
18848627944,82,35,receive,18843338910,5289034
18848629180,136,43,receive,18843335979,5293201
18848630885,190,28,receive,18843255113,5375772
18848633968,166,35,receive,18843313490,5320478
18848635753,70,42,receive,18843327401,5308352
18848636943,176,31,receive,18843329049,5307894
18848638182,172,39,receive,18843337285,5300897
18848639404,174,37,receive,18843314967,5324437
18848641471,186,49,receive,18843324435,5317036
18848643956,168,39,receive,18843377278,5266678
18848648084,62,39,receive,18843390957,5257127
18848649243,118,51,receive,18843380296,5268947
18848650987,46,50,receive,18843372105,5278882
18848652614,70,43,receive,18843386333,5266281
18848659866,38,48,receive,18843410685,5249181
18848676446,172,40,receive,18843363736,5312710
18848676824,166,36,receive,18843383915,5292909
18848677192,14,39,receive,18843411895,5265297
18848677646,82,36,receive,18843363839,5313807
18848678054,98,36,receive,18843367123,5310931
18848678989,176,32,receive,18843405947,5273042
18848679397,34,52,receive,18843457896,5221501
18848679792,172,41,receive,18843434280,5245512
18848691368,106,46,receive,18843461618,5229750
18848692137,128,46,receive,18843444377,5247760
18848693929,166,37,receive,18843442512,5251417
18848696135,118,52,receive,18843449641,5246494
18848696601,98,37,receive,18843458644,5237957
18848698336,82,38,receive,18843420811,5277525
18848710464,174,39,receive,18843443313,5267151
18848712086,70,44,receive,18843447077,5265009
18848713360,176,33,receive,18843424915,5288445
18848723429,24,48,receive,18843460862,5262567
18848724543,166,38,receive,18843467664,5256879
18848725771,136,45,receive,18843427436,5298335
18848727605,164,33,receive,18843459906,5267699
18848728612,48,44,receive,18843497686,5230926
18848730407,166,39,receive,18843480791,5249616
18848731624,184,41,receive,18843388252,5343372
18848733052,70,45,receive,18843505116,5227936
18848735687,90,43,receive,18843502372,5233315
18848737693,172,42,receive,18843504545,5233148
18848743113,174,40,receive,18843513643,5229470
18848746130,118,53,receive,18843508013,5238117
18848747759,190,29,receive,18843370796,5376963
18848752077,176,34,receive,18843498853,5253224
18848752875,176,35,receive,18843520509,5232366
18848755265,176,36,receive,18843520625,5234640
18848756428,82,42,receive,18843565904,5190524
18848757650,166,40,receive,18843533525,5224125
18848759856,194,39,receive,18843531841,5228015
18848761865,100,50,receive,18843532591,5229274
18848767364,70,46,receive,18843524223,5243141
18848768947,58,37,receive,18843528848,5240099
18848772748,30,41,receive,18843550280,5222468
18848774500,14,42,receive,18843536601,5237899
18848775345,184,42,receive,18843550710,5224635
18848775740,164,34,receive,18843543102,5232638
18848776914,176,37,receive,18843570976,5205938
18848779291,174,41,receive,18843522938,5256353
18848780591,198,35,receive,18843593761,5186830
18848782194,196,38,receive,18843607911,5174283
18848787986,58,38,receive,18843581408,5206578
18848789969,58,39,receive,18843623831,5166138
18848791283,166,41,receive,18843589263,5202020
18848793239,28,55,receive,18843605769,5187470
18848794429,196,39,receive,18843624366,5170063
18848796060,4,52,receive,18843587754,5208306
18848797522,178,45,receive,18843602550,5194972
18848799031,108,35,receive,18843611031,5188000
18848801348,162,52,receive,18843592691,5208657
18848802570,24,51,receive,18843608434,5194136
18848803333,118,55,receive,18843596297,5207036
18848806263,162,53,receive,18843658918,5147345
18848808338,42,58,receive,18843648628,5159710
18848810492,108,36,receive,18843645319,5165173
18848812652,4,53,receive,18843632134,5180518
18848814879,74,41,receive,18843657567,5157312
18848816409,110,47,receive,18843657411,5158998
18848818404,24,52,receive,18843658064,5160340
18848821354,176,39,receive,18843636367,5184987
18848824776,118,56,receive,18843639141,5185635
18848826145,112,54,receive,18843673008,5153137
18848827364,16,37,receive,18843574379,5252985
18848829020,12,47,receive,18843652203,5176817
18848831050,58,40,receive,18843635026,5196024
18848835160,4,55,receive,18843732283,5102877
18848838888,126,44,receive,18843693474,5145414
18848848821,98,44,receive,18843708646,5140175
18848850800,24,53,receive,18843688014,5162786
18848855803,48,48,receive,18843725644,5130159
18848857426,122,53,receive,18843673861,5183565
18848859411,120,61,receive,18843716795,5142616
18848860759,176,40,receive,18843702908,5157851
18848862664,52,60,receive,18843706167,5156497
18848863450,148,42,receive,18843738035,5125415
18848865067,154,48,receive,18843694046,5171021
18848867165,102,51,receive,18843739770,5127395
18848868365,118,57,receive,18843712973,5155392
18848869824,86,51,receive,18843770881,5098943
18848872817,30,46,receive,18843766127,5106690
18848874412,120,62,receive,18843786291,5088121
18848877895,148,43,receive,18843757389,5120506
18848879019,52,61,receive,18843774325,5104694
18848880637,20,44,receive,18843764435,5116202
18848883779,162,56,receive,18843787678,5096101
18848885297,154,49,receive,18843781623,5103674
18848888623,12,49,receive,18843765764,5122859
18848890281,8,46,receive,18843747633,5142648
18848891847,102,53,receive,18843758233,5133614
18848894331,176,41,receive,18843763207,5131124
18848895765,182,47,receive,18843789141,5106624
18848900433,50,50,receive,18843756528,5143905
18848901992,4,57,receive,18843808827,5093165
18848904251,198,39,receive,18843797055,5107196
18848905069,50,51,receive,18843837563,5067506
18848906663,20,45,receive,18843814192,5092471
18848908881,52,62,receive,18843839594,5069287
18848910553,154,51,receive,18843828528,5082025
18848912272,86,52,receive,18843828269,5084003
18848915465,102,54,receive,18843798926,5116539
18848917967,8,47,receive,18843828589,5089378
18848924552,12,50,receive,18843829396,5095156
18848926074,168,47,receive,18843813407,5112667
18848928065,156,45,receive,18843839823,5088242
18848929788,58,44,receive,18843811560,5118228
18848932280,16,39,receive,18843844237,5088043
18848933418,78,48,receive,18843876728,5056690
18848935970,102,55,receive,18843880727,5055243
18848938283,50,52,receive,18843860677,5077606
18848940369,88,47,receive,18843857393,5082976
18848942279,28,60,receive,18843856901,5085378
18848943835,20,46,receive,18843848920,5094915
18848946142,58,46,receive,18843873177,5072965
18848949124,66,48,receive,18843877732,5071392
18848951039,168,48,receive,18843883260,5067779
18848952244,76,64,receive,18843887552,5064692
18848954629,198,40,receive,18843880537,5074092
18848956644,30,49,receive,18843919748,5036896
18848958660,132,54,receive,18843902624,5056036
18848960931,58,47,receive,18843897375,5063556
18848962880,182,51,receive,18843903527,5059353
18848964894,22,58,receive,18843892950,5071944
18848966863,78,49,receive,18843895583,5071280
18848969456,50,53,receive,18843902336,5067120
18848971083,52,64,receive,18843911646,5059437
18848973013,102,56,receive,18843940914,5032099
18848975260,162,60,receive,18843925184,5050076
18848976880,102,57,receive,18843952138,5024742
18848979413,30,51,receive,18843990646,4988767
18848981079,190,35,receive,18843936113,5044966
18848983060,146,54,receive,18843956006,5027054
18848985098,28,62,receive,18843992257,4992841
18848987097,62,51,receive,18843974101,5012996
18848991501,138,53,receive,18843974857,5016644
18848993056,190,36,receive,18843996334,4996722
18848994677,58,48,receive,18843960010,5034667
18848996440,198,42,receive,18843982678,5013762
18848998042,176,45,receive,18843971999,5026043
18848999716,12,53,receive,18843996041,5003675
18849000924,42,66,receive,18843960491,5040433
18849002524,188,49,receive,18843988067,5014457
18849010574,28,63,receive,18844014112,4996462
18849017432,110,55,receive,18844044738,4972694
18849022826,138,54,receive,18844042267,4980559
18849024420,146,55,receive,18844039012,4985408
18849026075,146,56,receive,18844049515,4976560
18849028459,14,52,receive,18844049847,4978612
18849029619,176,46,receive,18844014671,5014948
18849030770,200,42,receive,18844041403,4989367
18849032345,68,55,receive,18844017725,5014620
18849033899,152,52,receive,18844013454,5020445
18849035607,42,67,receive,18844016664,5018943
18849038015,148,48,receive,18844052492,4985523
18849040077,198,43,receive,18844047838,4992239
18849045603,76,67,receive,18844008409,5037194
18849047217,138,55,receive,18844052552,4994665
18849050376,190,37,receive,18844047381,5002995
18849051566,28,64,receive,18844070161,4981405
18849053109,58,50,receive,18844065963,4987146
18849055372,110,56,receive,18844051496,5003876
18849057697,164,40,receive,18844044994,5012703
18849058492,152,53,receive,18844093286,4965206
18849067051,146,57,receive,18844090968,4976083
18849069162,200,43,receive,18844081974,4987188
18849072520,76,68,receive,18844092146,4980374
18849074361,14,53,receive,18844060154,5014207
18849075717,134,59,receive,18844085873,4989844
18849076998,50,56,receive,18844091221,4985777
18849079467,134,60,receive,18844112429,4967038
18849081766,148,50,receive,18844145431,4936335
18849083464,200,45,receive,18844158067,4925397
18849084653,170,58,receive,18844158255,4926398
18849086614,12,56,receive,18844149312,4937302
18849088566,44,56,receive,18844149976,4938590
18849092786,24,60,receive,18844156874,4935912
18849095006,146,58,receive,18844116808,4978198
18849097051,148,51,receive,18844159484,4937567
18849098994,68,57,receive,18844110130,4988864
18849101027,60,58,receive,18844116044,4984983
18849102949,174,53,receive,18844138038,4964911
18849104852,14,55,receive,18844202324,4902528
18849106774,146,59,receive,18844172585,4934189
18849110070,188,53,receive,18844196807,4913263
18849112118,60,59,receive,18844173542,4938576
18849113307,130,61,receive,18844171003,4942304
18849115335,8,54,receive,18844210914,4904421
18849116611,46,67,receive,18844179880,4936731
18849119775,148,52,receive,18844161596,4958179
18849121459,76,70,receive,18844170721,4950738
18849123091,84,58,receive,18844191703,4931388
18849128079,128,61,receive,18844210249,4917830
18849133326,192,57,receive,18844178384,4954942
18849134963,104,59,receive,18844157837,4977126
18849137510,44,57,receive,18844176312,4961198
18849139139,120,72,receive,18844239452,4899687
18849143581,146,60,receive,18844222063,4921518
18849144974,192,58,receive,18844244664,4900310
18849147314,66,58,receive,18844264379,4882935
18849148470,50,59,receive,18844249373,4899097
18849150029,8,55,receive,18844224221,4925808
18849151224,174,55,receive,18844228757,4922467
18849159936,80,69,receive,18844267135,4892801
18849162069,46,68,receive,18844263129,4898940
18849163217,76,71,receive,18844252548,4910669
18849165178,114,66,receive,18844252630,4912548
18849166996,8,56,receive,18844268418,4898578
18849168983,180,59,receive,18844316007,4852976
18849170199,94,59,receive,18844291587,4878612
18849171783,174,56,receive,18844310991,4860792
18849174353,150,65,receive,18844278840,4895513
18849176341,80,70,receive,18844309428,4866913
18849177943,156,56,receive,18844298429,4879514
18849180276,112,66,receive,18844311380,4868896
18849182299,146,61,receive,18844280497,4901802
18849184529,156,57,receive,18844351377,4833152
18849186136,120,74,receive,18844334325,4851811
18849188139,80,71,receive,18844332478,4855661
18849190081,16,44,receive,18844340097,4849984
18849192112,174,57,receive,18844333650,4858462
18849193683,22,68,receive,18844367076,4826607
18849195637,150,66,receive,18844353344,4842293
18849199214,112,67,receive,18844370863,4828351
18849201186,114,69,receive,18844371351,4829835
18849203141,46,70,receive,18844370415,4832726
18849204833,44,60,receive,18844345089,4859744
18849206869,150,67,receive,18844372046,4834823
18849208879,24,64,receive,18844337444,4871435
18849211517,94,61,receive,18844384204,4827313
18849213017,120,75,receive,18844385843,4827174
18849215550,44,61,receive,18844406636,4808914
18849218050,24,65,receive,18844398070,4819980
18849220091,36,74,receive,18844423212,4796879
18849221482,126,52,receive,18844293075,4928407
18849223597,140,84,receive,18844408897,4814700
18849225627,54,65,receive,18844392613,4833014
18849227611,90,61,receive,18844411847,4815764
18849230097,46,71,receive,18844394934,4835163
18849231512,112,68,receive,18844415372,4816140
18849235252,146,63,receive,18844426105,4809147
18849236810,174,58,receive,18844402722,4834088
18849238375,96,76,receive,18844398027,4840348
18849239994,176,53,receive,18844393517,4846477
18849241583,186,71,receive,18844475113,4766470
18849245680,70,68,receive,18844472795,4772885
18849248062,114,71,receive,18844461789,4786273
18849251513,14,60,receive,18844429721,4821792
18849253058,36,75,receive,18844470832,4782226
18849254259,96,77,receive,18844447945,4806314
18849255414,174,59,receive,18844437487,4817927
18849256598,90,62,receive,18844457350,4799248
18849258305,178,63,receive,18844459341,4798964
18849259975,126,53,receive,18844452480,4807495
18849262110,106,65,receive,18844470988,4791122
18849264254,146,64,receive,18844467520,4796734
18849265796,172,60,receive,18844500132,4765664
18849267915,44,63,receive,18844524752,4743163
18849270270,178,64,receive,18844487924,4782346
18849271919,178,65,receive,18844530122,4741797
18849273498,148,58,receive,18844519979,4753519
18849276374,14,61,receive,18844487736,4788638
18849278338,42,77,receive,18844527633,4750705
18849280885,142,61,receive,18844488282,4792603
18849283497,174,60,receive,18844516660,4766837
18849285077,96,78,receive,18844497821,4787256
18849287101,72,53,receive,18844502589,4784512
18849289031,4,72,receive,18844522560,4766471
18849290675,20,58,receive,18844497793,4792882
18849292984,126,55,receive,18844567356,4725628
18849296254,112,72,receive,18844541830,4754424
18849302491,128,68,receive,18844549820,4752671
18849303825,20,59,receive,18844570448,4733377
18849305201,26,66,receive,18844568105,4737096
18849306563,142,62,receive,18844559927,4746636
