receive_timestamp,source_vehicle,message_id,event_type,send_timestamp,latency_us
18841367631,140,2,receive,18841322159,45472
18841368024,84,1,receive,18841323743,44281
18841368349,66,1,receive,18841324019,44330
18841368651,70,1,receive,18841326788,41863
18841368955,70,2,receive,18841327272,41683
18841369256,34,2,receive,18841328992,40264
18841369562,100,1,receive,18841329814,39748
18841369879,136,1,receive,18841330056,39823
18841370278,126,1,receive,18841330084,40194
18841370602,96,1,receive,18841331263,39339
18841371007,96,2,receive,18841331899,39108
18841371341,140,3,receive,18841332856,38485
18841371683,102,1,receive,18841332884,38799
18841372040,122,1,receive,18841333860,38180
18841372365,76,2,receive,18841334009,38356
18841372687,120,2,receive,18841334414,38273
18841373004,118,1,receive,18841335105,37899
18841373325,118,2,receive,18841335873,37452
18841373649,140,4,receive,18841337258,36391
18841374009,138,1,receive,18841338523,35486
18841374337,120,3,receive,18841338815,35522
18841374657,56,2,receive,18841339254,35403
18841374978,28,2,receive,18841340023,34955
18841375304,80,2,receive,18841341130,34174
18841375624,6,1,receive,18841341213,34411
18841376049,34,3,receive,18841341509,34540
18841376386,86,3,receive,18841341639,34747
18841376713,38,1,receive,18841341795,34918
18841775264,86,4,receive,18841342029,433235
18841775694,118,3,receive,18841342899,432795
18841776136,140,5,receive,18841345630,430506
18841776632,76,3,receive,18841345913,430719
18841777091,64,1,receive,18841346302,430789
18841777525,10,1,receive,18841346504,431021
18841778014,92,2,receive,18841347742,430272
18841778959,52,2,receive,18841348572,430387
18841779398,140,6,receive,18841348951,430447
18841779865,142,1,receive,18841349378,430487
18842029396,54,2,receive,18841349713,679683
18842029806,120,4,receive,18841350221,679585
18842030212,16,1,receive,18841352218,677994
18842030611,48,1,receive,18841352766,677845
18842030989,8,1,receive,18841353060,677929
18842031368,110,1,receive,18841353267,678101
18842031763,86,5,receive,18841353353,678410
18842032152,158,2,receive,18841354631,677521
18842032535,50,1,receive,18841354700,677835
18842032916,36,2,receive,18841354783,678133
18842033297,154,2,receive,18841355166,678131
18842033699,76,4,receive,18841355306,678393
18842034086,156,1,receive,18841356683,677403
18842034465,20,2,receive,18841357182,677283
18842034844,40,2,receive,18841357689,677155
18842035246,24,1,receive,18841357913,677333
18842035626,192,1,receive,18841358295,677331
18842035996,26,2,receive,18841359280,676716
18842036405,66,2,receive,18841359433,676972
18842036788,30,1,receive,18841360804,675984
18842037172,150,1,receive,18841360895,676277
18842037551,96,3,receive,18841361211,676340
18842037957,132,1,receive,18841361305,676652
18842038345,42,2,receive,18841362809,675536
18842038723,46,1,receive,18841362920,675803
18842068515,114,1,receive,18841364200,704315
18842068945,88,1,receive,18841364557,704388
18842069358,20,3,receive,18841365456,703902
18842069784,96,4,receive,18841365704,704080
18842070209,84,2,receive,18841366799,703410
18842070620,40,3,receive,18841366904,703716
18842071042,120,5,receive,18841367514,703528
18842071453,136,2,receive,18841367664,703789
18842109492,2,1,receive,18841369372,740120
18842109947,80,3,receive,18841369642,740305
18842110411,34,4,receive,18841370016,740395
18842110970,112,1,receive,18841370738,740232
18842111536,78,1,receive,18841372617,738919
18842112039,104,1,receive,18841373015,739024
18842112542,98,2,receive,18841373202,739340
18842112991,184,1,receive,18841373484,739507
18842113482,180,1,receive,18841374003,739479
18842113947,86,6,receive,18841374688,739259
18842114438,60,1,receive,18841375025,739413
18842199387,12,1,receive,18841375431,823956
18842199844,128,1,receive,18841376126,823718
18842200315,136,3,receive,18841376934,823381
18842200790,80,4,receive,18841377901,822889
18842201271,154,3,receive,18841378095,823176
18842201721,126,2,receive,18841378314,823407
18842202196,192,2,receive,18841378700,823496
18842202649,190,1,receive,18841380050,822599
18842203149,124,1,receive,18841380566,822583
18842203629,6,2,receive,18841380910,822719
18842204101,28,3,receive,18841381006,823095
18842250875,146,1,receive,18841381406,869469
18842251327,166,1,receive,18841381576,869751
18842251799,144,1,receive,18841381709,870090
18842252243,62,1,receive,18841382102,870141
18842252685,134,1,receive,18841382195,870490
18842253126,140,7,receive,18841382284,870842
18842253584,164,1,receive,18841382545,871039
18842254027,36,3,receive,18841383315,870712
18842254472,76,5,receive,18841383766,870706
18842254915,76,6,receive,18841383973,870942
18842255358,106,1,receive,18841384342,871016
18842255813,38,2,receive,18841384942,870871
18842306324,102,2,receive,18841385390,920934
18842306807,122,2,receive,18841385759,921048
18842307269,188,1,receive,18841385938,921331
18842307762,92,3,receive,18841386262,921500
18842308205,170,1,receive,18841388448,919757
18842308660,52,3,receive,18841389199,919461
18842309103,6,3,receive,18841390009,919094
18842309547,152,1,receive,18841390024,919523
18842309994,28,4,receive,18841391342,918652
18842310454,156,2,receive,18841392769,917685
18842365564,168,1,receive,18841393182,972382
18842366021,14,1,receive,18841394788,971233
18842366473,56,3,receive,18841394879,971594
18842366931,154,4,receive,18841395438,971493
18842367396,6,4,receive,18841396300,971096
18842367840,86,7,receive,18841396895,970945
18842368314,54,3,receive,18841397175,971139
18842368757,126,3,receive,18841398254,970503
18842369214,156,3,receive,18841398552,970662
18842369660,120,6,receive,18841398863,970797
18842420028,36,4,receive,18841399133,1020895
18842420484,42,3,receive,18841399372,1021112
18842420931,70,3,receive,18841399851,1021080
18842421412,48,2,receive,18841400154,1021258
18842421852,118,4,receive,18841400269,1021583
18842422303,158,3,receive,18841402023,1020280
18842422755,178,1,receive,18841402480,1020275
18842423206,70,4,receive,18841404117,1019089
18842423651,84,3,receive,18841404244,1019407
18842424095,146,2,receive,18841404704,1019391
18842424554,138,2,receive,18841405178,1019376
18842474899,26,3,receive,18841405602,1069297
18842475352,120,7,receive,18841406062,1069290
18842475808,76,7,receive,18841406334,1069474
18842476266,80,5,receive,18841407310,1068956
18842476718,136,4,receive,18841408450,1068268
18842477164,118,5,receive,18841409639,1067525
18842477613,74,1,receive,18841409941,1067672
18842478063,34,5,receive,18841409983,1068080
18842478514,192,3,receive,18841410163,1068351
18842478962,40,4,receive,18841410392,1068570
18842479405,122,3,receive,18841410490,1068915
18842479859,142,2,receive,18841410654,1069205
18842529599,86,8,receive,18841411176,1118423
18842530069,6,5,receive,18841411424,1118645
18842530527,144,2,receive,18841411857,1118670
18842531016,16,2,receive,18841412216,1118800
18842531473,180,2,receive,18841412571,1118902
18842531927,150,2,receive,18841412613,1119314
18842532374,94,1,receive,18841412614,1119760
18842532810,64,2,receive,18841413663,1119147
18842533265,126,4,receive,18841415105,1118160
18842533707,38,3,receive,18841415464,1118243
18842584925,96,5,receive,18841415720,1169205
18842585393,194,1,receive,18841415814,1169579
18842585843,200,1,receive,18841415786,1170057
18842586292,98,3,receive,18841416110,1170182
18842586753,158,4,receive,18841416244,1170509
18842587206,114,2,receive,18841417053,1170153
18842587666,66,3,receive,18841417220,1170446
18842588111,46,2,receive,18841417578,1170533
18842588563,120,8,receive,18841418274,1170289
18842589004,36,5,receive,18841418363,1170641
18842589495,136,5,receive,18841418779,1170716
18842640738,46,3,receive,18841419594,1221144
18842641198,56,4,receive,18841419746,1221452
18842641672,122,4,receive,18841419853,1221819
18842642127,188,2,receive,18841420914,1221213
18842642598,162,1,receive,18841420931,1221667
18842643055,152,2,receive,18841421553,1221502
18842643524,52,4,receive,18841421620,1221904
18842643996,102,3,receive,18841422110,1221886
18842644451,76,8,receive,18841422313,1222138
18842644927,26,4,receive,18841423914,1221013
18842645403,140,8,receive,18841424670,1220733
18842696460,176,1,receive,18841425565,1270895
18842696967,84,4,receive,18841425678,1271289
18842697417,164,2,receive,18841427217,1270200
18842697888,168,2,receive,18841427524,1270364
18842698353,172,1,receive,18841427625,1270728
18842698827,158,5,receive,18841428464,1270363
18842699273,132,2,receive,18841428579,1270694
18842699716,118,6,receive,18841429393,1270323
18842700185,150,3,receive,18841429975,1270210
18842700631,140,9,receive,18841430860,1269771
18842701073,140,10,receive,18841431015,1270058
18842751437,64,3,receive,18841431338,1320099
18842751947,28,5,receive,18841431670,1320277
18842752399,78,2,receive,18841433479,1318920
18842752878,186,1,receive,18841434160,1318718
18842753335,184,2,receive,18841434274,1319061
18842753797,106,2,receive,18841434815,1318982
18842754235,46,4,receive,18841435295,1318940
18842754681,6,6,receive,18841435479,1319202
18842755153,64,4,receive,18841435682,1319471
18842755654,30,2,receive,18841436304,1319350
18842756116,92,4,receive,18841436913,1319203
18842806702,132,3,receive,18841439057,1367645
18842807160,112,2,receive,18841439377,1367783
18842807686,60,2,receive,18841440018,1367668
18842808146,122,5,receive,18841440303,1367843
18842808605,110,2,receive,18841440292,1368313
18842809056,200,2,receive,18841440539,1368517
18842809550,102,4,receive,18841440645,1368905
18842810021,174,1,receive,18841441323,1368698
18842810485,22,1,receive,18841442093,1368392
18842810929,168,3,receive,18841442346,1368583
18842861737,76,9,receive,18841442614,1419123
18842862221,180,3,receive,18841442729,1419492
18842862709,154,5,receive,18841442939,1419770
18842863245,194,2,receive,18841443033,1420212
18842863722,14,2,receive,18841444078,1419644
18842864178,84,5,receive,18841444999,1419179
18842864669,140,11,receive,18841445235,1419434
18842865148,170,2,receive,18841445630,1419518
18842865650,70,5,receive,18841447520,1418130
18842866136,94,2,receive,18841448245,1417891
18842866612,138,3,receive,18841448355,1418257
18842917918,152,3,receive,18841448425,1469493
18842918385,158,6,receive,18841449746,1468639
18842918854,156,4,receive,18841449772,1469082
18842919328,42,4,receive,18841450340,1468988
18842919779,26,5,receive,18841451198,1468581
18842920265,16,3,receive,18841451391,1468874
18842920742,80,6,receive,18841452503,1468239
18842921214,66,4,receive,18841453576,1467638
18842921671,66,5,receive,18841453741,1467930
18842922144,24,2,receive,18841448067,1474077
18842978075,158,7,receive,18841453944,1524131
18842978606,88,2,receive,18841453971,1524635
18842979109,54,4,receive,18841454004,1525105
18842979617,104,2,receive,18841454291,1525326
18842980129,178,2,receive,18841454596,1525533
18842980610,48,3,receive,18841454817,1525793
18842981109,4,1,receive,18841455267,1525842
18842981613,162,2,receive,18841455911,1525702
18842982117,136,6,receive,18841456378,1525739
18842982655,132,4,receive,18841458545,1524110
18842983152,116,1,receive,18841458675,1524477
18843038772,80,7,receive,18841458793,1579979
18843039262,38,4,receive,18841459804,1579458
18843039724,114,3,receive,18841460010,1579714
18843040218,80,8,receive,18841460010,1580208
18843040714,30,3,receive,18841460014,1580700
18843041224,46,5,receive,18841460061,1581163
18843041684,124,2,receive,18841460306,1581378
18843042140,144,3,receive,18841460404,1581736
18843042595,86,9,receive,18841460496,1582099
18843043068,36,6,receive,18841460778,1582290
18843043539,36,7,receive,18841460926,1582613
18843100807,102,5,receive,18841460907,1639900
18843101284,34,6,receive,18841461034,1640250
18843101768,92,5,receive,18841461229,1640539
18843102229,76,10,receive,18841461908,1640321
18843102682,142,3,receive,18841462051,1640631
18843103135,40,5,receive,18841462518,1640617
18843103618,96,6,receive,18841462581,1641037
18843104088,146,3,receive,18841445866,1658222
18843104551,186,2,receive,18841464273,1640278
18843105002,56,5,receive,18841464548,1640454
18843156296,52,5,receive,18841465177,1691119
18843156759,142,4,receive,18841465292,1691467
18843157236,146,4,receive,18841465413,1691823
18843157720,70,6,receive,18841465807,1691913
18843158203,164,3,receive,18841466073,1692130
18843158733,56,6,receive,18841466766,1691967
18843159200,120,9,receive,18841467642,1691558
18843159674,118,7,receive,18841467833,1691841
18843160140,116,2,receive,18841468028,1692112
18843160591,48,4,receive,18841469240,1691351
18843161061,150,4,receive,18841469460,1691601
18843212716,114,4,receive,18841470010,1742706
18843213181,122,6,receive,18841470009,1743172
18843213660,24,3,receive,18841470696,1742964
18843214111,14,3,receive,18841472058,1742053
18843214553,164,4,receive,18841472296,1742257
18843215018,106,3,receive,18841472359,1742659
18843215482,64,5,receive,18841473159,1742323
18843216013,66,6,receive,18841473980,1742033
18843216472,12,2,receive,18841474171,1742301
18843216921,4,2,receive,18841474744,1742177
18843267518,76,11,receive,18841475188,1792330
18843268021,184,3,receive,18841475362,1792659
18843268491,14,4,receive,18841475441,1793050
18843268955,88,3,receive,18841475477,1793478
18843269414,28,6,receive,18841475984,1793430
18843269877,58,1,receive,18841477068,1792809
18843270365,12,3,receive,18841477429,1792936
18843270818,168,4,receive,18841477870,1792948
18843271276,112,3,receive,18841478966,1792310
18843271737,188,3,receive,18841480010,1791727
18843321778,94,3,receive,18841480009,1841769
18843322255,176,2,receive,18841480316,1841939
18843322714,38,5,receive,18841482074,1840640
18843323181,156,5,receive,18841482489,1840692
18843323785,106,4,receive,18841482810,1840975
18843324251,180,4,receive,18841483696,1840555
18843324746,134,2,receive,18841454589,1870157
18843325230,172,2,receive,18841484065,1841165
18843325692,180,5,receive,18841484890,1840802
18843326179,102,6,receive,18841485708,1840471
18843326635,78,3,receive,18841485852,1840783
18843378242,134,3,receive,18841485922,1892320
18843378656,106,5,receive,18841486074,1892582
18843379043,38,6,receive,18841486237,1892806
18843379450,92,6,receive,18841486565,1892885
18843379835,26,6,receive,18841486611,1893224
18843380334,92,7,receive,18841486773,1893561
18843380811,36,8,receive,18841487170,1893641
18843381300,124,3,receive,18841487563,1893737
18843381771,24,4,receive,18841487568,1894203
18843382229,16,4,receive,18841490023,1892206
18843382683,150,5,receive,18841490256,1892427
18843433242,48,5,receive,18841490373,1942869
18843433739,118,8,receive,18841490458,1943281
18843434226,84,6,receive,18841491411,1942815
18843434693,48,6,receive,18841491606,1943087
18843435173,146,5,receive,18841491771,1943402
18843435653,162,3,receive,18841492037,1943616
18843436136,28,7,receive,18841493230,1942906
18843436603,34,7,receive,18841493323,1943280
18843437085,154,6,receive,18841493365,1943720
18843437569,76,12,receive,18841493501,1944068
18843487822,186,3,receive,18841493599,1994223
18843488303,140,12,receive,18841493723,1994580
18843488771,40,6,receive,18841493863,1994908
18843489269,4,3,receive,18841494259,1995010
18843489757,38,7,receive,18841494423,1995334
18843490238,40,7,receive,18841495035,1995203
18843490739,54,5,receive,18841495395,1995344
18843491315,96,7,receive,18841496054,1995261
18843491784,42,5,receive,18841496142,1995642
18843492242,134,4,receive,18841497883,1994359
18843542878,12,4,receive,18841498154,2044724
18843543347,174,2,receive,18841498346,2045001
18843543799,48,7,receive,18841498843,2044956
18843544250,136,7,receive,18841498920,2045330
18843544736,132,5,receive,18841499405,2045331
18843545212,186,4,receive,18841499788,2045424
18843545688,120,10,receive,18841499893,2045795
18843546156,178,3,receive,18841500596,2045560
18843546626,26,7,receive,18841500840,2045786
18843547093,124,4,receive,18841500880,2046213
18843547550,140,13,receive,18841500933,2046617
18843598159,74,2,receive,18841471475,2126684
18843598596,96,8,receive,18841501222,2097374
18843599034,192,4,receive,18841466300,2132734
18843599488,178,4,receive,18841501778,2097710
18843599990,86,10,receive,18841501849,2098141
18843600457,138,4,receive,18841502033,2098424
18843600866,172,3,receive,18841502322,2098544
18843601276,158,8,receive,18841502289,2098987
18843601758,168,5,receive,18841502511,2099247
18843602219,134,5,receive,18841503120,2099099
18843602674,122,7,receive,18841504033,2098641
18843653530,70,7,receive,18841505238,2148292
18843654018,96,9,receive,18841505408,2148610
18843654505,128,2,receive,18841451092,2203413
18843654968,14,5,receive,18841506824,2148144
18843655430,80,9,receive,18841507479,2147951
18843655886,28,8,receive,18841508538,2147348
18843656358,2,2,receive,18841478221,2178137
18843656812,64,6,receive,18841510539,2146273
18843657277,26,8,receive,18841511030,2146247
18843657779,154,7,receive,18841511583,2146196
18843709864,4,4,receive,18841511611,2198253
18843710341,118,9,receive,18841511777,2198564
18843710809,30,4,receive,18841512035,2198774
18843711293,94,4,receive,18841512680,2198613
18843711768,114,5,receive,18841512876,2198892
18843712237,46,6,receive,18841514651,2197586
18843712734,88,4,receive,18841514878,2197856
18843713250,124,5,receive,18841514983,2198267
18843713711,8,2,receive,18841515097,2198614
18843714156,8,3,receive,18841515283,2198873
18843714607,184,4,receive,18841515603,2199004
18843715077,114,6,receive,18841516092,2198985
18843766300,116,3,receive,18841508921,2257379
18843766805,128,4,receive,18841516592,2250213
18843767281,114,7,receive,18841517257,2250024
18843767737,122,8,receive,18841518240,2249497
18843768200,24,5,receive,18841518855,2249345
18843768662,140,14,receive,18841519145,2249517
18843769177,162,4,receive,18841520028,2249149
18843769647,86,11,receive,18841520079,2249568
18843770119,76,13,receive,18841520782,2249337
18843770548,64,7,receive,18841520789,2249759
18843816332,180,6,receive,18841521117,2295215
18843816805,48,8,receive,18841521129,2295676
18843817302,96,10,receive,18841521628,2295674
18843817792,174,3,receive,18841522068,2295724
18843818269,70,8,receive,18841522470,2295799
18843818726,136,8,receive,18841524167,2294559
18843819181,164,5,receive,18841524328,2294853
18843819642,42,6,receive,18841524508,2295134
18843820119,192,5,receive,18841524910,2295209
18843820595,156,6,receive,18841525765,2294830
18843871996,128,5,receive,18841526827,2345169
18843872479,178,5,receive,18841526988,2345491
18843872971,118,10,receive,18841528989,2343982
18843873447,84,7,receive,18841529671,2343776
18843873913,150,6,receive,18841531116,2342797
18843874386,40,8,receive,18841531365,2343021
18843874903,146,6,receive,18841531387,2343516
18843875367,38,8,receive,18841531695,2343672
18843875827,188,4,receive,18841531881,2343946
18843876288,42,7,receive,18841532761,2343527
18843927155,120,11,receive,18841533253,2393902
18843927632,188,5,receive,18841534140,2393492
18843928082,78,4,receive,18841535175,2392907
18843928570,114,8,receive,18841535472,2393098
18843929037,24,6,receive,18841536082,2392955
18843929518,76,14,receive,18841537023,2392495
18843929982,150,7,receive,18841537333,2392649
18843930442,148,1,receive,18841537877,2392565
18843930896,96,11,receive,18841537926,2392970
18843931364,168,6,receive,18841538653,2392711
18843931816,154,8,receive,18841538835,2392981
18843982964,134,6,receive,18841539377,2443587
18843983451,134,7,receive,18841539530,2443921
18843984113,34,8,receive,18841539584,2444529
18843984595,106,6,receive,18841537066,2447529
18843985073,192,6,receive,18841540292,2444781
18843985600,70,9,receive,18841540685,2444915
18843986066,128,6,receive,18841542078,2443988
18843986620,172,4,receive,18841542152,2444468
18843987093,46,7,receive,18841543130,2443963
18844033311,34,9,receive,18841543855,2489456
18844033781,28,9,receive,18841543860,2489921
18844034250,84,8,receive,18841544085,2490165
18844034711,118,11,receive,18841544269,2490442
18844035177,162,5,receive,18841544304,2490873
18844035634,30,5,receive,18841544287,2491347
18844036089,166,2,receive,18841389871,2646218
18844036544,158,9,receive,18841544666,2491878
18844037009,134,8,receive,18841544681,2492328
18844037468,54,6,receive,18841545284,2492184
18844083971,158,10,receive,18841545832,2538139
18844084417,164,6,receive,18841546640,2537777
18844084891,180,7,receive,18841547371,2537520
18844085385,108,1,receive,18841548209,2537176
18844085847,138,5,receive,18841549309,2536538
18844086296,14,6,receive,18841549873,2536423
18844086755,20,4,receive,18841411866,2674889
18844087240,64,8,receive,18841550149,2537091
18844087707,44,1,receive,18841550178,2537529
18844088210,120,12,receive,18841551474,2536736
18844143143,192,7,receive,18841551593,2591550
18844143685,70,10,receive,18841551916,2591769
18844144151,28,10,receive,18841552038,2592113
18844144618,122,9,receive,18841554838,2589780
18844145116,80,10,receive,18841555980,2589136
18844145595,116,4,receive,18841556215,2589380
18844146066,28,11,receive,18841556211,2589855
18844146536,84,9,receive,18841556371,2590165
18844147064,2,3,receive,18841557184,2589880
18844147529,82,1,receive,18841558026,2589503
18844198583,76,15,receive,18841558303,2640280
18844199058,26,9,receive,18841558407,2640651
18844199539,24,7,receive,18841559341,2640198
18844200009,46,8,receive,18841559425,2640584
18844200701,164,7,receive,18841559861,2640840
18844201159,8,4,receive,18841561406,2639753
18844201623,184,5,receive,18841562656,2638967
18844202423,132,6,receive,18841562754,2639669
18844202801,140,15,receive,18841563520,2639281
18844203271,42,8,receive,18841564149,2639122
18844203742,70,11,receive,18841565166,2638576
18844253941,146,7,receive,18841565743,2688198
18844254414,154,9,receive,18841566112,2688302
18844254912,4,5,receive,18841566381,2688531
18844255554,10,2,receive,18841418508,2837046
18844256046,150,8,receive,18841566586,2689460
18844256547,48,9,receive,18841566973,2689574
18844257016,174,4,receive,18841567347,2689669
18844257515,44,2,receive,18841568500,2689015
18844257995,128,7,receive,18841569375,2688620
18844258475,26,10,receive,18841569620,2688855
18844309619,38,9,receive,18841569937,2739682
18844310106,182,1,receive,18841570033,2740073
18844310572,106,7,receive,18841571337,2739235
18844311057,178,6,receive,18841571376,2739681
18844311529,136,9,receive,18841572649,2738880
18844311994,40,9,receive,18841572703,2739291
18844312460,56,7,receive,18841517272,2795188
18844312932,144,4,receive,18841520012,2792920
18844313403,118,12,receive,18841573531,2739872
18844313876,46,9,receive,18841573738,2740138
18844367138,158,11,receive,18841574102,2793036
18844367623,90,1,receive,18841574373,2793250
18844368085,4,6,receive,18841574591,2793494
18844368556,26,11,receive,18841574804,2793752
18844369019,78,5,receive,18841576557,2792462
18844369485,10,3,receive,18841576599,2792886
18844369955,30,6,receive,18841576676,2793279
18844370445,98,4,receive,18841456372,2914073
18844370914,98,5,receive,18841576897,2794017
18844371370,118,13,receive,18841577732,2793638
18844371836,48,10,receive,18841578237,2793599
18844372309,96,12,receive,18841578330,2793979
18844372782,2,4,receive,18841579521,2793261
18844428934,154,10,receive,18841580007,2848927
18844429418,190,2,receive,18841510019,2919399
18844429897,174,5,receive,18841580547,2849350
18844430412,120,13,receive,18841580710,2849702
18844430890,42,9,receive,18841582362,2848528
18844431358,162,6,receive,18841584118,2847240
18844431834,128,3,receive,18841508148,2923686
18844432298,154,11,receive,18841585203,2847095
18844432766,2,5,receive,18841585782,2846984
18844433242,46,10,receive,18841586072,2847170
18844483978,132,7,receive,18841586073,2897905
18844484453,80,11,receive,18841586319,2898134
18844484982,64,9,receive,18841587566,2897416
18844485442,94,5,receive,18841557061,2928381
18844485915,168,7,receive,18841588195,2897720
18844486406,34,10,receive,18841588292,2898114
18844486873,114,9,receive,18841577858,2909015
18844487373,82,2,receive,18841589429,2897944
18844487834,82,3,receive,18841589609,2898225
18844488310,112,4,receive,18841493445,2994865
18844488762,54,7,receive,18841590647,2898115
18844539160,150,9,receive,18841591095,2948065
18844539686,96,13,receive,18841591578,2948108
18844540163,82,4,receive,18841591844,2948319
18844540620,196,1,receive,18841591887,2948733
18844541080,162,7,receive,18841592278,2948802
18844541544,178,7,receive,18841592466,2949078
18844542012,162,8,receive,18841593439,2948573
18844542478,166,3,receive,18841593950,2948528
18844542947,38,10,receive,18841594243,2948704
18844543422,112,5,receive,18841594477,2948945
18844595952,174,6,receive,18841594750,3001202
18844596434,70,12,receive,18841595721,3000713
18844596941,174,7,receive,18841596903,3000038
18844597398,60,3,receive,18841488048,3109350
18844597885,130,2,receive,18841332370,3265515
18844598385,134,9,receive,18841598435,2999950
18844598853,116,5,receive,18841598645,3000208
18844599321,14,7,receive,18841599297,3000024
18844599791,28,12,receive,18841599498,3000293
18844600254,28,13,receive,18841599654,3000600
18844647679,138,6,receive,18841599874,3047805
18844648180,146,8,receive,18841599885,3048295
18844648663,146,9,receive,18841600075,3048588
18844649153,140,16,receive,18841600882,3048271
18844649636,122,10,receive,18841601136,3048500
18844650124,14,8,receive,18841601473,3048651
18844650594,76,16,receive,18841601874,3048720
18844651060,26,12,receive,18841601983,3049077
18844651540,192,8,receive,18841602249,3049291
18844652008,128,8,receive,18841602719,3049289
18844703522,96,14,receive,18841602857,3100665
18844703975,128,9,receive,18841602922,3101053
18844704489,150,10,receive,18841603277,3101212
18844704966,122,11,receive,18841603429,3101537
18844705539,116,6,receive,18841603814,3101725
18844706007,56,8,receive,18841604020,3101987
18844706494,140,17,receive,18841604135,3102359
18844706955,24,8,receive,18841605910,3101045
18844707463,122,12,receive,18841607661,3099802
18844707940,186,5,receive,18841524036,3183904
18844708394,184,6,receive,18841608202,3100192
18844759923,132,8,receive,18841608378,3151545
18844760407,36,9,receive,18841535781,3224626
18844760872,64,10,receive,18841609526,3151346
18844761359,112,6,receive,18841609804,3151555
18844761851,142,5,receive,18841499817,3262034
18844762312,44,3,receive,18841609890,3152422
18844762801,104,3,receive,18841509649,3253152
18844763507,8,5,receive,18841611055,3152452
18844763977,146,10,receive,18841611300,3152677
18844764491,8,6,receive,18841612305,3152186
18844821145,44,4,receive,18841613081,3208064
18844821645,120,14,receive,18841613134,3208511
18844822133,6,7,receive,18841467879,3354254
18844822640,78,6,receive,18841613968,3208672
18844823107,68,1,receive,18841614228,3208879
18844823593,146,11,receive,18841615470,3208123
18844824056,24,9,receive,18841616099,3207957
18844824520,140,18,receive,18841616320,3208200
18844824999,134,10,receive,18841616670,3208329
18844825473,54,8,receive,18841616954,3208519
18844877309,194,3,receive,18841492562,3384747
18844878813,136,10,receive,18841619025,3259788
18844879312,46,11,receive,18841619468,3259844
18844879792,126,5,receive,18841433446,3446346
18844880274,158,12,receive,18841621580,3258694
18844880729,78,7,receive,18841622119,3258610
18844881249,166,4,receive,18841622271,3258978
18844881815,130,3,receive,18841622963,3258852
18844882462,98,6,receive,18841623227,3259235
18844934032,30,7,receive,18841624208,3309824
18844934517,132,9,receive,18841624692,3309825
18844935006,190,3,receive,18841625080,3309926
18844935490,96,15,receive,18841625129,3310361
18844935977,118,14,receive,18841625155,3310822
18844936453,124,6,receive,18841544081,3392372
18844937171,168,8,receive,18841625747,3311424
18844937859,106,8,receive,18841626172,3311687
18844989784,104,4,receive,18841626236,3363548
18844990757,184,7,receive,18841626464,3364293
18844991224,14,9,receive,18841626725,3364499
18844991900,38,11,receive,18841627627,3364273
18844992391,178,8,receive,18841627759,3364632
18844992940,42,10,receive,18841629756,3363184
18844993411,10,4,receive,18841630008,3363403
18844993880,162,9,receive,18841630808,3363072
18844994359,14,10,receive,18841630907,3363452
18845047275,138,7,receive,18841631178,3416097
18845047753,44,5,receive,18841631384,3416369
18845048651,154,12,receive,18841631539,3417112
18845049139,192,9,receive,18841633530,3415609
18845049654,34,11,receive,18841633706,3415948
18845050149,38,12,receive,18841635776,3414373
18845050578,80,12,receive,18841635817,3414761
18845051043,132,10,receive,18841635962,3415081
18845051501,158,13,receive,18841636768,3414733
18845051972,14,11,receive,18841636058,3415914
18845104407,26,13,receive,18841637182,3467225
18845104914,114,10,receive,18841637372,3467542
18845105394,102,7,receive,18841537843,3567551
18845105882,96,16,receive,18841638378,3467504
18845106335,36,10,receive,18841638591,3467744
18845106814,96,17,receive,18841638584,3468230
18845107409,60,4,receive,18841638825,3468584
18845107889,64,11,receive,18841638839,3469050
18845108448,48,11,receive,18841639009,3469439
18845108940,82,5,receive,18841639206,3469734
18845109384,160,1,receive,18841639352,3470032
18845162798,30,8,receive,18841639485,3523313
18845163280,140,19,receive,18841639526,3523754
18845163741,22,2,receive,18841524382,3639359
18845164309,170,3,receive,18841477321,3686988
18845164770,8,7,receive,18841640654,3524116
18845165313,166,5,receive,18841641497,3523816
18845165780,154,13,receive,18841641715,3524065
18845166265,112,7,receive,18841642235,3524030
18845166727,146,12,receive,18841642736,3523991
18845167202,30,9,receive,18841643674,3523528
18845224033,116,7,receive,18841643883,3580150
18845224997,122,13,receive,18841644032,3580965
18845226156,130,4,receive,18841644181,3581975
18845228216,114,11,receive,18841645541,3582675
18845228739,150,11,receive,18841645893,3582846
18845286422,142,6,receive,18841646053,3640369
18845286796,74,3,receive,18841544086,3742710
18845287214,54,9,receive,18841646286,3640928
18845287624,52,6,receive,18841512631,3774993
18845288000,166,6,receive,18841646753,3641247
18845288363,158,14,receive,18841646942,3641421
18845288731,76,17,receive,18841647204,3641527
18845289101,132,11,receive,18841648242,3640859
18845289492,28,14,receive,18841649052,3640440
18845289958,22,3,receive,18841649886,3640072
18845290358,100,2,receive,18841369790,3920568
18845290834,86,12,receive,18841549382,3741452
18845344758,104,5,receive,18841650583,3694175
18845345202,142,7,receive,18841651232,3693970
18845345570,120,15,receive,18841651893,3693677
18845345938,118,15,receive,18841652429,3693509
18845346333,136,11,receive,18841653291,3693042
18845346746,140,20,receive,18841653792,3692954
18845347140,126,6,receive,18841653949,3693191
18845347521,28,15,receive,18841654258,3693263
18845347902,48,12,receive,18841655293,3692609
18845348296,194,4,receive,18841656437,3691859
18845348673,116,8,receive,18841656211,3692462
18845349041,44,6,receive,18841656647,3692394
18845349423,48,13,receive,18841657511,3691912
18845349798,158,15,receive,18841658145,3691653
18845350238,46,12,receive,18841659816,3690422
18845403411,36,11,receive,18841660988,3742423
18845403859,6,8,receive,18841661968,3741891
18845404320,190,4,receive,18841662468,3741852
18845404736,118,16,receive,18841662614,3742122
18845405800,102,8,receive,18841664379,3741421
18845406232,106,9,receive,18841664534,3741698
18845406614,112,8,receive,18841665521,3741093
18845406991,154,14,receive,18841665902,3741089
18845407373,60,5,receive,18841666202,3741171
18845407753,80,13,receive,18841666381,3741372
18845463653,162,10,receive,18841667086,3796567
18845464060,100,3,receive,18841667245,3796815
18845464462,184,8,receive,18841667787,3796675
18845464846,104,6,receive,18841667833,3797013
18845465228,184,9,receive,18841667983,3797245
18845465604,42,11,receive,18841668104,3797500
18845465980,112,9,receive,18841668761,3797219
18845466428,138,8,receive,18841670480,3795948
18845466815,96,18,receive,18841670935,3795880
18845467191,96,19,receive,18841671119,3796072
18845467564,10,5,receive,18841671389,3796175
18845467961,106,10,receive,18841671696,3796265
18845515333,98,7,receive,18841672527,3842806
18845515808,118,18,receive,18841673931,3841877
18845516277,34,12,receive,18841674075,3842202
18845516740,102,9,receive,18841674644,3842096
18845517220,190,5,receive,18841674718,3842502
18845517682,120,16,receive,18841675074,3842608
18845518140,30,10,receive,18841675063,3843077
18845518653,100,4,receive,18841675452,3843201
18845519123,80,14,receive,18841676143,3842980
18845519672,118,19,receive,18841677132,3842540
18845573292,150,12,receive,18841677171,3896121
18845573767,48,14,receive,18841677371,3896396
18845574235,76,18,receive,18841677472,3896763
18845574733,170,4,receive,18841677614,3897119
18845575203,184,10,receive,18841678197,3897006
18845575667,64,12,receive,18841678270,3897397
18845576128,28,16,receive,18841678595,3897533
18845576610,18,1,receive,18841679593,3897017
18845577063,68,2,receive,18841641526,3935537
18845577544,134,11,receive,18841646934,3930610
18845578014,6,9,receive,18841680190,3897824
18845624636,36,12,receive,18841680327,3944309
18845625220,198,1,receive,18841680913,3944307
18845625726,112,10,receive,18841681015,3944711
18845626214,34,13,receive,18841681236,3944978
18845626697,26,14,receive,18841681561,3945136
18845627218,10,6,receive,18841681583,3945635
18845627686,132,12,receive,18841681666,3946020
18845628168,36,13,receive,18841683581,3944587
18845628637,100,5,receive,18841683659,3944978
18845629124,54,10,receive,18841683696,3945428
18845681634,8,8,receive,18841684301,3997333
18845682104,162,11,receive,18841684373,3997731
18845682575,200,3,receive,18841478907,4203668
18845683047,126,7,receive,18841684580,3998467
18845683505,98,8,receive,18841684736,3998769
18845684064,140,21,receive,18841685036,3999028
18845684782,32,1,receive,18841685113,3999669
18845685267,38,13,receive,18841685203,4000064
18845685754,114,12,receive,18841685903,3999851
18845686365,190,6,receive,18841685999,4000366
18845732869,80,15,receive,18841686387,4046482
18845733341,66,7,receive,18841513223,4220118
18845824755,96,20,receive,18841686434,4138321
18845825029,162,12,receive,18841686521,4138508
18845825277,114,13,receive,18841687084,4138193
18845825520,128,10,receive,18841626169,4199351
18845825764,34,14,receive,18841687437,4138327
18845826130,128,11,receive,18841689253,4136877
18845826406,108,2,receive,18841587673,4238733
18845826654,176,3,receive,18841512925,4313729
18845826923,68,3,receive,18841690190,4136733
18845827194,154,15,receive,18841690334,4136860
18845827438,136,12,receive,18841690573,4136865
18845827702,118,17,receive,18841669760,4157942
18845827946,96,21,receive,18841690695,4137251
18845828192,76,19,receive,18841690725,4137467
18845828487,36,14,receive,18841690817,4137670
18845828737,74,4,receive,18841691162,4137575
18845828983,52,7,receive,18841692736,4136247
18845829228,26,15,receive,18841692795,4136433
18845829476,200,4,receive,18841693632,4135844
18845834121,152,4,receive,18841495786,4338335
18845834395,122,14,receive,18841694742,4139653
18845834642,86,13,receive,18841695423,4139219
18845834891,112,11,receive,18841696330,4138561
18845835133,80,16,receive,18841697724,4137409
18845868639,22,4,receive,18841698228,4170411
18845868942,58,2,receive,18841486358,4382584
18845869189,118,20,receive,18841698422,4170767
18845869434,140,22,receive,18841699260,4170174
18845870035,142,8,receive,18841699541,4170494
18845872894,46,13,receive,18841701724,4171170
18845873203,122,15,receive,18841701954,4171249
18845873449,102,10,receive,18841702147,4171302
18845873687,116,9,receive,18841702450,4171237
18845873928,96,22,receive,18841702967,4170961
18845874165,112,12,receive,18841703541,4170624
18845874405,194,5,receive,18841703772,4170633
18845874667,126,8,receive,18841703854,4170813
18845874977,10,7,receive,18841704865,4170112
18845875374,138,9,receive,18841704952,4170422
18845875747,80,17,receive,18841704966,4170781
18845875986,82,6,receive,18841650553,4225433
18845876226,76,20,receive,18841705945,4170281
18845919706,36,15,receive,18841706053,4213653
18845919972,190,7,receive,18841706312,4213660
18845988560,158,16,receive,18841707381,4281179
18845988993,8,9,receive,18841707674,4281319
18845989585,132,13,receive,18841707996,4281589
18845990122,134,12,receive,18841708339,4281783
18845990560,114,14,receive,18841708365,4282195
18845990990,150,13,receive,18841708481,4282509
18845991436,42,12,receive,18841709497,4281939
18845991820,42,13,receive,18841709631,4282189
18845992207,198,2,receive,18841710279,4281928
18846038053,40,10,receive,18841601946,4436107
18846075176,190,8,receive,18841710529,4364647
18846075420,2,6,receive,18841609282,4466138
18846075670,106,11,receive,18841711902,4363768
18846075909,98,9,receive,18841712041,4363868
18846076153,28,17,receive,18841712963,4363190
18846076394,68,4,receive,18841713591,4362803
18846076670,42,14,receive,18841713797,4362873
18846076912,98,10,receive,18841714181,4362731
18846077147,188,6,receive,18841546511,4530636
18846077385,60,6,receive,18841714757,4362628
18846077624,52,8,receive,18841715162,4362462
18846077863,140,23,receive,18841715378,4362485
18846078109,10,8,receive,18841717063,4361046
18846078352,120,17,receive,18841717389,4360963
18846078612,158,17,receive,18841717525,4361087
18846174379,134,13,receive,18841717575,4456804
18846174745,10,9,receive,18841719213,4455532
18846268462,28,18,receive,18841719195,4549267
18846268711,142,9,receive,18841719787,4548924
18846268956,106,12,receive,18841720126,4548830
18846269198,12,5,receive,18841561216,4707982
18846269442,188,7,receive,18841720410,4549032
18846269685,32,2,receive,18841720548,4549137
18846269938,164,8,receive,18841601252,4668686
18846270197,36,16,receive,18841721332,4548865
18846270456,172,5,receive,18841569369,4701087
18846270699,86,14,receive,18841722727,4547972
18846270942,152,5,receive,18841722927,4548015
18846271187,142,10,receive,18841723022,4548165
18846271442,54,11,receive,18841723017,4548425
18846271682,64,13,receive,18841723318,4548364
18846271957,160,2,receive,18841678903,4593054
18846272202,184,11,receive,18841723641,4548561
18846272537,170,5,receive,18841723934,4548603
18846272793,88,5,receive,18841544227,4728566
18846344891,114,15,receive,18841725565,4619326
18846347431,158,18,receive,18841725698,4621733
18846347685,106,13,receive,18841726329,4621356
18846347931,130,6,receive,18841726878,4621053
18846348177,46,14,receive,18841727030,4621147
18846349327,56,11,receive,18841775020,4574307
18846372392,118,24,receive,18841775424,4596968
18846372649,198,4,receive,18841775833,4596816
18846372894,140,26,receive,18841776021,4596873
18846373137,158,19,receive,18841776064,4597073
18846373377,186,7,receive,18841776432,4596945
18846437231,46,15,receive,18841776504,4660727
18846437489,136,14,receive,18841777287,4660202
18846437733,96,24,receive,18841777676,4660057
18846514579,102,12,receive,18841779002,4735577
18846515591,152,7,receive,18841779502,4736089
18846515845,30,11,receive,18841708602,4807243
18846517027,52,10,receive,18841781709,4735318
18846517306,68,6,receive,18841781988,4735318
18846517560,186,8,receive,18841782606,4734954
18846517801,182,4,receive,18841782657,4735144
18846518044,186,9,receive,18841783766,4734278
18846518287,186,10,receive,18841783886,4734401
18846518555,8,12,receive,18841785508,4733047
18846518796,156,8,receive,18841785524,4733272
18846519054,82,7,receive,18841711636,4807418
18846519321,148,2,receive,18841574296,4945025
18846583768,74,8,receive,18841788111,4795657
18846584068,120,22,receive,18841788415,4795653
18846584333,76,22,receive,18841788601,4795732
18846584583,46,16,receive,18841788733,4795850
18846584825,180,8,receive,18841572803,5012022
18846585075,186,11,receive,18841789019,4796056
18846585337,110,7,receive,18841789210,4796127
18846585625,120,23,receive,18841790597,4795028
18846585876,80,21,receive,18841781050,4804826
18846586130,4,7,receive,18841603874,4982256
18846586376,90,3,receive,18841792901,4793475
18846586639,116,11,receive,18841793037,4793602
18846586961,36,18,receive,18841793156,4793805
18846587204,48,15,receive,18841720731,4866473
18846587451,190,10,receive,18841794878,4792573
18846587690,52,11,receive,18841797002,4790688
18846587929,136,15,receive,18841797441,4790488
18846588192,88,7,receive,18841797956,4790236
18846588432,68,7,receive,18841798193,4790239
18846588673,34,18,receive,18841798535,4790138
18846588914,42,17,receive,18841798872,4790042
18846589157,100,8,receive,18841799816,4789341
18846649745,170,9,receive,18841799852,4849893
18846650018,196,2,receive,18841600169,5049849
18846650264,78,8,receive,18841636304,5013960
18846650511,96,25,receive,18841800192,4850319
18846650795,68,8,receive,18841800365,4850430
18846651089,166,7,receive,18841676492,4974597
18846651673,66,11,receive,18841800892,4850781
18846651926,108,3,receive,18841727853,4924073
18846652171,182,5,receive,18841802918,4849253
18846652414,180,9,receive,18841804194,4848220
18846652659,168,10,receive,18841805096,4847563
18846652918,144,9,receive,18841805106,4847812
18846653188,116,12,receive,18841805200,4847988
18846653458,144,10,receive,18841805309,4848149
18846653701,136,16,receive,18841805682,4848019
18846653942,42,18,receive,18841806058,4847884
18846654183,86,16,receive,18841807179,4847004
18846654424,114,17,receive,18841807187,4847237
18846654684,22,9,receive,18841807576,4847108
18846654923,42,19,receive,18841809249,4845674
18846655195,130,9,receive,18841809656,4845539
18846655443,122,18,receive,18841811199,4844244
18846655687,186,12,receive,18841811246,4844441
18846656125,100,9,receive,18841811997,4844128
18846656372,118,25,receive,18841812705,4843667
18846717900,116,13,receive,18841813388,4904512
18846718370,56,12,receive,18841813357,4905013
18846718673,96,26,receive,18841813572,4905101
18846719165,152,8,receive,18841813765,4905400
18846719415,170,10,receive,18841814060,4905355
18846719665,34,19,receive,18841814778,4904887
18846719922,198,5,receive,18841815174,4904748
18846720182,162,13,receive,18841727344,4992838
18846720437,74,9,receive,18841815425,4905012
18846720682,140,27,receive,18841815698,4904984
18846720923,56,13,receive,18841816624,4904299
18846721179,90,4,receive,18841817159,4904020
18846721421,140,28,receive,18841817899,4903522
18846721663,8,13,receive,18841818877,4902786
18846721905,126,9,receive,18841739219,4982686
18846799297,140,29,receive,18841820599,4978698
18846799594,158,20,receive,18841822474,4977120
18846799871,28,21,receive,18841822963,4976908
18846800199,78,9,receive,18841824553,4975646
18846800516,104,7,receive,18841699199,5101317
18846800762,104,8,receive,18841825131,4975631
18846801103,68,9,receive,18841825431,4975672
18846801375,118,26,receive,18841825919,4975456
18846801620,24,10,receive,18841641426,5160194
18846801882,110,8,receive,18841826548,4975334
18846802128,20,5,receive,18841591400,5210728
18846802387,34,20,receive,18841828009,4974378
18846802630,126,10,receive,18841828263,4974367
18846802875,180,10,receive,18841828478,4974397
18846803125,116,14,receive,18841828612,4974513
18846803377,4,8,receive,18841829214,4974163
18846803622,58,3,receive,18841742824,5060798
18846880653,68,10,receive,18841829569,5051084
18846880921,150,14,receive,18841717712,5163209
18846881160,100,10,receive,18841831174,5049986
18846881409,86,17,receive,18841831453,5049956
18846881650,96,27,receive,18841831797,5049853
18846881890,22,10,receive,18841832777,5049113
18846882147,78,10,receive,18841832985,5049162
18846882385,8,14,receive,18841833097,5049288
18846955656,182,6,receive,18841833287,5122369
18846955906,186,13,receive,18841833436,5122470
18846956185,22,11,receive,18841834911,5121274
18846957033,120,24,receive,18841835026,5122007
18846957275,136,17,receive,18841835073,5122202
18846957514,16,7,receive,18841797629,5159885
18846957756,36,19,receive,18841835547,5122209
18846957996,36,20,receive,18841836746,5121250
18846958254,76,23,receive,18841837003,5121251
18846958497,130,5,receive,18841690581,5267916
18846958762,162,14,receive,18841838645,5120117
18846958999,130,10,receive,18841839909,5119090
18846959342,200,5,receive,18841716123,5243219
18846959870,24,11,receive,18841841688,5118182
18846960152,96,28,receive,18841842009,5118143
18846960401,136,18,receive,18841842201,5118200
18846960665,88,8,receive,18841842303,5118362
18847003954,80,22,receive,18841842369,5161585
18847004492,132,14,receive,18841742394,5262098
18847004885,110,9,receive,18841843747,5161138
18847005336,78,11,receive,18841845258,5160078
18847005726,42,20,receive,18841846483,5159243
18847006102,24,12,receive,18841846908,5159194
18847006476,52,12,receive,18841847466,5159010
18847006852,106,14,receive,18841775725,5231127
18847007475,16,8,receive,18841848527,5158948
18847007902,12,6,receive,18841758587,5249315
18847008318,56,14,receive,18841851139,5157179
18847008687,112,14,receive,18841894212,5114475
18847009108,126,13,receive,18841932687,5076421
18847009498,78,13,receive,18841932952,5076546
18847009911,38,17,receive,18841933099,5076812
18847042409,130,13,receive,18841933824,5108585
18847042825,22,17,receive,18841934048,5108777
18847043213,140,33,receive,18841934679,5108534
18847043597,100,17,receive,18841934846,5108751
18847044054,142,13,receive,18841802956,5241098
18847044422,150,17,receive,18841935325,5109097
18847044794,28,26,receive,18841935378,5109416
18847045166,180,13,receive,18841935399,5109767
18847045538,100,18,receive,18841937017,5108521
18847045966,42,22,receive,18841937219,5108747
18847101372,148,5,receive,18841938793,5162579
18847101757,12,9,receive,18841939167,5162590
18847102285,22,18,receive,18841939231,5163054
18847102886,112,15,receive,18841934229,5168657
18847103268,146,14,receive,18841939530,5163738
18847103757,190,11,receive,18841819219,5284538
18847104140,44,8,receive,18841889027,5215113
18847104506,52,18,receive,18841942063,5162443
18847104894,76,26,receive,18841887689,5217205
18847105255,38,18,receive,18841943352,5161903
18847105676,186,18,receive,18841943761,5161915
18847175802,140,34,receive,18841943857,5231945
18847176535,162,19,receive,18841944112,5232423
18847176935,6,13,receive,18841944127,5232808
18847177301,30,12,receive,18841821043,5356258
18847177671,50,3,receive,18841784636,5393035
18847178043,188,8,receive,18841757738,5420305
18847178471,72,3,receive,18841785908,5392563
18847178842,6,14,receive,18841946277,5232565
18847179316,16,10,receive,18841947390,5231926
18847179702,128,14,receive,18841786169,5393533
18847180127,188,9,receive,18841947552,5232575
18847180506,26,17,receive,18841773744,5406762
18847180879,116,16,receive,18841904096,5276783
18847181251,172,8,receive,18841948306,5232945
18847206499,70,15,receive,18841883243,5323256
18847206895,98,13,receive,18841917288,5289607
18847207273,88,11,receive,18841950132,5257141
18847210054,52,19,receive,18841951238,5258816
18847210429,4,11,receive,18841951826,5258603
18847210825,60,10,receive,18841806130,5404695
18847262176,130,14,receive,18841953077,5309099
18847262991,132,17,receive,18841954537,5308454
18847263433,62,6,receive,18841956192,5307241
18847263878,60,11,receive,18841956270,5307608
18847264256,172,9,receive,18841957488,5306768
18847264634,196,4,receive,18841957891,5306743
18847265007,14,13,receive,18841883395,5381612
18847265339,174,10,receive,18841958425,5306914
18847265591,16,11,receive,18841958671,5306920
18847265847,186,19,receive,18841957004,5308843
18847266095,146,15,receive,18841959733,5306362
18847266338,104,14,receive,18841959906,5306432
18847266585,198,6,receive,18841848604,5417981
18847266842,124,8,receive,18841907816,5359026
18847267091,130,15,receive,18841962226,5304865
18847267332,24,13,receive,18841874235,5393097
18847267588,138,12,receive,18841962676,5304912
18847348671,170,14,receive,18841963328,5385343
18847348974,112,16,receive,18841963720,5385254
