receive_timestamp,source_vehicle,message_id,event_type,send_timestamp,latency_us
373649661,210,2,receive,373363083,286578
373650089,230,3,receive,373364522,285567
373651217,778,4,receive,373364429,286788
373651579,592,1,receive,373364608,286971
373651981,488,1,receive,373367149,284832
373652344,426,4,receive,373367583,284761
373652701,332,1,receive,373367726,284975
373653134,354,1,receive,373368455,284679
373653927,114,5,receive,373368894,285033
373654260,582,1,receive,373368957,285303
373654588,86,4,receive,373369044,285544
373654964,640,1,receive,373369448,285516
373655309,166,2,receive,373358761,296548
373655644,300,1,receive,373370044,285600
373986777,192,1,receive,373370182,616595
373987378,712,1,receive,373370313,617065
373987811,486,3,receive,373371338,616473
373988691,130,3,receive,373309045,679646
373989137,524,1,receive,373374149,614988
373989640,130,4,receive,373373933,615707
373990156,530,1,receive,373374600,615556
373990588,436,1,receive,373374829,615759
373991012,130,5,receive,373375029,615983
374235541,636,2,receive,373376013,859528
374236036,90,5,receive,373376866,859170
374236593,508,1,receive,373376887,859706
374237056,130,6,receive,373376476,860580
374237487,972,2,receive,373377276,860211
374237911,426,5,receive,373377644,860267
374238354,634,3,receive,373378345,860009
374239971,918,1,receive,373378463,861508
374476894,618,1,receive,373379066,1097828
374477293,166,3,receive,373380013,1097280
374477856,112,2,receive,373285041,1192815
374478277,8,5,receive,373278178,1200099
374478710,196,6,receive,373381922,1096788
374479117,868,3,receive,373382063,1097054
374479691,90,6,receive,373382316,1097375
374480203,340,1,receive,373296934,1183269
374480621,400,4,receive,373382781,1097840
374481044,432,3,receive,373383008,1098036
374481476,486,4,receive,373383975,1097501
374481981,126,2,receive,373305048,1176933
374734733,222,1,receive,373375932,1358801
374735224,316,1,receive,373386209,1349015
374735805,486,5,receive,373386787,1349018
374736286,730,2,receive,373387278,1349008
374736726,2,5,receive,373273391,1463335
374737172,154,3,receive,373388709,1348463
374737624,734,1,receive,373389539,1348085
374738094,444,1,receive,373334200,1403894
374738992,638,1,receive,373371725,1367267
375083851,436,2,receive,373390018,1693833
375084326,492,2,receive,373390020,1694306
375084911,366,1,receive,373390145,1694766
375085347,618,2,receive,373390437,1694910
375085923,62,4,receive,373250337,1835586
375086391,774,1,receive,373390624,1695767
375086849,756,1,receive,373390885,1695964
375087292,554,2,receive,373391272,1696020
375087769,196,7,receive,373391318,1696451
375088232,678,1,receive,373391717,1696515
375088676,964,2,receive,373391772,1696904
375297738,724,1,receive,373392160,1905578
375314020,64,4,receive,373354344,1959676
375314628,488,2,receive,373393759,1920869
375315038,798,3,receive,373393968,1921070
375315443,320,4,receive,373394395,1921048
375315901,222,2,receive,373395466,1920435
375316317,778,5,receive,373395541,1920776
375316727,778,6,receive,373395881,1920846
375317135,32,3,receive,373285087,2032048
375317549,206,4,receive,373396720,1920829
375318034,336,1,receive,373396941,1921093
375555737,2,6,receive,373393761,2161976
375556165,766,2,receive,373397603,2158562
375556885,352,1,receive,373355333,2201552
375557396,164,2,receive,373287511,2269885
375557818,434,1,receive,373398867,2158951
375558233,804,1,receive,373398932,2159301
375558676,456,2,receive,373399942,2158734
375559077,612,2,receive,373391742,2167335
375559498,858,1,receive,373343766,2215732
375559903,150,5,receive,373400589,2159314
375560317,330,1,receive,373400981,2159336
375805053,560,1,receive,373401198,2403855
375805517,204,2,receive,373401651,2403866
375806088,564,1,receive,373401672,2404416
375806569,222,3,receive,373402437,2404132
375807041,778,7,receive,373402673,2404368
375807552,230,4,receive,373403215,2404337
375808039,586,1,receive,373403229,2404810
375808510,670,3,receive,373403888,2404622
375808979,982,1,receive,373404064,2404915
375809448,592,2,receive,373404299,2405149
376053224,994,1,receive,373404655,2648569
376053695,554,3,receive,373404704,2648991
376054324,634,4,receive,373405133,2649191
376054806,634,5,receive,373405599,2649207
376055307,426,6,receive,373405950,2649357
376055785,964,3,receive,373407361,2648424
376056252,316,2,receive,373407547,2648705
376056755,844,1,receive,373407892,2648863
376057227,586,2,receive,373408806,2648421
376057696,566,1,receive,373360373,2697323
376306419,482,1,receive,373410119,2896300
376306900,370,1,receive,373410438,2896462
376307511,836,1,receive,373411253,2896258
376307997,836,2,receive,373411872,2896125
376308468,54,2,receive,373411868,2896600
376308930,150,6,receive,373412059,2896871
376309399,252,2,receive,373415349,2894050
376309901,448,2,receive,373327134,2982767
376310383,312,3,receive,373415998,2894385
376310869,238,1,receive,373416159,2894710
376545128,312,4,receive,373416340,3128788
376545740,868,4,receive,373416750,3128990
376546134,396,1,receive,373416732,3129402
376546597,640,2,receive,373417199,3129398
376547035,318,1,receive,373417412,3129623
376547438,746,1,receive,373420030,3127408
376547897,530,2,receive,373420076,3127821
376548306,192,2,receive,373420126,3128180
376548703,810,1,receive,373420516,3128187
376549088,502,1,receive,373422960,3126128
376549471,888,1,receive,373423157,3126314
376813076,892,1,receive,373424788,3388288
376813548,896,1,receive,373425194,3388354
376814086,244,1,receive,373425208,3388878
376814514,924,1,receive,373425571,3388943
376814913,82,3,receive,373387972,3426941
376815397,964,4,receive,373427070,3388327
376815799,300,2,receive,373427165,3388634
376816193,492,3,receive,373427954,3388239
376816589,332,2,receive,373417168,3399421
376816983,166,4,receive,373430014,3386969
376817471,428,1,receive,373430101,3387370
376817995,792,1,receive,373430663,3387332
377069649,450,1,receive,373431662,3637987
377070076,582,2,receive,373432544,3637532
377070600,506,1,receive,373432861,3637739
377070990,538,1,receive,373433495,3637495
377071433,478,1,receive,373433985,3637448
377071834,230,5,receive,373434750,3637084
377072220,498,1,receive,373436296,3635924
377072603,964,5,receive,373438204,3634399
377073004,166,5,receive,373438419,3634585
377073517,300,3,receive,373438927,3634590
377073998,224,1,receive,373439255,3634743
377320124,124,1,receive,373430406,3889718
377320525,860,1,receive,373336252,3984273
377321030,486,6,receive,373440016,3881014
377321432,136,1,receive,373374011,3947421
377321890,258,1,receive,373440131,3881759
377322271,788,1,receive,373440383,3881888
377322649,584,1,receive,373440677,3881972
377323026,860,2,receive,373442319,3880707
377323426,972,3,receive,373442573,3880853
377323883,352,2,receive,373443173,3880710
377324304,598,2,receive,373443786,3880518
377548987,312,5,receive,373444006,4104981
377549382,612,3,receive,373444252,4105130
377549927,868,5,receive,373446264,4103663
377550314,150,7,receive,373447583,4102731
377550705,730,3,receive,373448020,4102685
377551070,964,6,receive,373450038,4101032
377551434,358,1,receive,373450130,4101304
377551827,364,1,receive,373450269,4101558
377552283,430,1,receive,373450892,4101391
377552692,240,1,receive,373451132,4101560
377553092,312,6,receive,373451246,4101846
377553486,656,1,receive,373452049,4101437
377806554,284,2,receive,373428397,4378157
377806934,696,1,receive,373453421,4353513
377807485,362,1,receive,373453682,4353803
377807870,320,5,receive,373453829,4354041
377808281,252,3,receive,373455163,4353118
377808708,274,2,receive,373407508,4401200
377809116,338,2,receive,373455536,4353580
377809494,510,1,receive,373456262,4353232
377809896,730,4,receive,373457374,4352522
377810294,868,6,receive,373457618,4352676
377810674,420,1,receive,373457777,4352897
377811058,456,3,receive,373458002,4353056
378057798,240,2,receive,373458406,4599392
378058257,228,1,receive,373458664,4599593
378058827,404,1,receive,373458775,4600052
378059274,766,3,receive,373459094,4600180
378059721,606,1,receive,373459342,4600379
378060178,356,1,receive,373459582,4600596
378060647,908,1,receive,373460048,4600599
378061124,304,1,receive,373460382,4600742
378061571,236,1,receive,373460929,4600642
378062003,178,1,receive,373391181,4670822
378310319,500,1,receive,373461772,4848547
378310801,598,3,receive,373462312,4848489
378311404,616,1,receive,373463550,4847854
378311857,334,1,receive,373464651,4847206
378312314,360,1,receive,373465058,4847256
378312824,634,6,receive,373465210,4847614
378313267,252,4,receive,373467636,4845631
378313740,274,3,receive,373467950,4845790
378314202,282,1,receive,373468146,4846056
378509832,456,4,receive,373468388,5041444
378510312,352,3,receive,373468467,5041845
378510859,932,1,receive,373468666,5042193
378511253,204,3,receive,373469146,5042107
378511633,292,1,receive,373469744,5041889
378512119,818,3,receive,373470014,5042105
378512498,492,4,receive,373470026,5042472
378512901,458,1,receive,373470440,5042461
378513270,472,1,receive,373470774,5042496
378513910,516,1,receive,373471220,5042690
378514305,120,1,receive,373471753,5042552
378709261,54,3,receive,373474163,5235098
378709805,486,7,receive,373475225,5234580
378710360,408,4,receive,373392875,5317485
378710833,370,2,receive,373476086,5234747
378711285,766,4,receive,373476408,5234877
378711706,606,2,receive,373476561,5235145
378712122,982,2,receive,373476707,5235415
378712581,982,3,receive,373476867,5235714
378713003,228,2,receive,373477160,5235843
378713412,316,3,receive,373478532,5234880
378908950,392,1,receive,373478739,5430211
378909367,748,1,receive,373478888,5430479
378909974,54,4,receive,373479436,5430538
378910371,490,2,receive,373480012,5430359
378910821,390,1,receive,373431611,5479210
378911204,366,2,receive,373480020,5431184
378911580,226,1,receive,373480139,5431441
378911955,230,6,receive,373480317,5431638
378912332,594,1,receive,373481328,5431004
378912770,396,2,receive,373480017,5432753
378913165,566,2,receive,373484217,5428948
379111484,536,1,receive,373484445,5627039
379111913,540,1,receive,373484657,5627256
379112438,54,5,receive,373484734,5627704
379112817,868,7,receive,373485244,5627573
379113195,868,8,receive,373485392,5627803
379113662,582,3,receive,373485551,5628111
379114126,252,5,receive,373485678,5628448
379114525,424,1,receive,373485734,5628791
379114916,686,1,receive,373485805,5629111
379115307,460,1,receive,373485961,5629346
379115728,894,1,receive,373486260,5629468
379302174,930,1,receive,373487515,5814659
379302576,230,7,receive,373487562,5815014
379303189,730,5,receive,373487701,5815488
379303572,630,1,receive,373488852,5814720
379304024,486,8,receive,373490018,5814006
379304434,178,2,receive,373490028,5814406
379304836,480,1,receive,373490052,5814784
379305226,452,1,receive,373490037,5815189
379305634,270,1,receive,373490046,5815588
379306047,810,2,receive,373490188,5815859
379306460,510,2,receive,373490340,5816120
379493111,288,1,receive,373490364,6002747
379493519,616,2,receive,373490511,6003008
379494042,652,1,receive,373490767,6003275
379494445,502,2,receive,373491603,6002842
379494901,256,1,receive,373491569,6003332
379495311,804,2,receive,373491752,6003559
379495715,612,4,receive,373491969,6003746
379496116,658,1,receive,373493505,6002611
379496559,680,1,receive,373493696,6002863
379497001,150,8,receive,373494010,6002991
379497380,320,6,receive,373494150,6003230
379657944,606,3,receive,373494155,6163789
379658376,488,3,receive,373494165,6164211
379658883,314,1,receive,373494678,6164205
379659268,456,5,receive,373495781,6163487
379659757,810,3,receive,373496340,6163417
379660774,242,1,receive,373496508,6164266
379661177,972,4,receive,373497069,6164108
379661629,350,1,receive,373497271,6164358
379662422,470,1,receive,373497556,6164866
379662894,524,2,receive,373498165,6164729
379841138,786,1,receive,373610231,6230907
379841601,712,4,receive,373610947,6230654
379842140,606,6,receive,373611269,6230871
379842563,678,3,receive,373611267,6231296
379843002,682,2,receive,373611231,6231771
379843383,604,1,receive,373611325,6232058
379843757,946,3,receive,373611406,6232351
379844158,906,1,receive,373611427,6232731
379844543,750,3,receive,373611473,6233070
379844916,420,5,receive,373611542,6233374
379845290,514,3,receive,373611552,6233738
379978789,556,3,receive,373611672,6367117
379979253,988,1,receive,373611684,6367569
379979895,358,5,receive,373612270,6367625
379980378,524,6,receive,373612353,6368025
379980781,648,1,receive,373612508,6368273
379981285,776,2,receive,373613268,6368017
379981684,734,5,receive,373613802,6367882
379982167,742,1,receive,373613802,6368365
379982602,516,2,receive,373614131,6368471
379983038,228,3,receive,373614512,6368526
380134697,854,3,receive,373614555,6520142
380135100,152,5,receive,373380372,6754728
380135596,486,13,receive,373614798,6520798
380135971,924,3,receive,373614848,6521123
380136445,896,3,receive,373614984,6521461
380136874,926,2,receive,373615028,6521846
380137281,362,3,receive,373615112,6522169
380137675,712,5,receive,373615227,6522448
380138100,606,7,receive,373616290,6521810
380138486,478,5,receive,373616458,6522028
380138860,418,5,receive,373616589,6522271
380285242,634,11,receive,373616724,6668518
380285640,378,2,receive,373650017,6635623
380286187,624,1,receive,373710298,6575889
380286574,344,3,receive,373710981,6575593
380287034,502,12,receive,373714193,6572841
380287420,268,5,receive,373715283,6572137
380287809,606,11,receive,373715662,6572147
380288232,304,2,receive,373715698,6572534
380288627,864,3,receive,373715834,6572793
380289150,982,11,receive,373716210,6572940
380289551,434,3,receive,373716451,6573100
380414568,926,5,receive,373716462,6698106
380414975,110,4,receive,373392551,7022424
380415479,842,4,receive,373716623,6698856
380415938,368,7,receive,373717763,6698175
380416322,52,7,receive,373873999,6542323
380416740,492,9,receive,373622166,6794574
380417171,242,2,receive,373638073,6779098
380417652,318,4,receive,373826327,6591325
380418439,134,3,receive,373845611,6572828
380419271,492,10,receive,373989152,6430119
380559731,728,4,receive,373809394,6750337
380560150,448,4,receive,373850813,6709337
380560638,378,4,receive,373741797,6818841
380561043,222,4,receive,373656211,6904832
380561830,56,6,receive,374008513,6553317
380562540,308,5,receive,373996071,6566469
380563299,4,8,receive,374005506,6557793
380563791,728,5,receive,374040078,6523713
380678712,260,3,receive,373970630,6708082
380679286,56,7,receive,374239152,6440134
380679829,734,12,receive,373881808,6798021
380680336,882,4,receive,374041286,6639050
380680764,240,7,receive,374144218,6536546
380681519,470,5,receive,374273620,6407899
380682130,156,6,receive,374257177,6424953
380682813,866,3,receive,374266330,6416483
380808296,366,8,receive,374258866,6549430
380808703,610,4,receive,374213398,6595305
380809208,490,8,receive,374267218,6541990
380809626,884,5,receive,374272383,6537243
380810648,654,16,receive,374236516,6574132
380811053,154,6,receive,373934609,6876444
380811446,150,16,receive,374272900,6538546
380811856,354,8,receive,374297296,6514560
380812266,56,9,receive,374510870,6301396
380812655,632,7,receive,374515543,6297112
380813035,854,11,receive,374531517,6281518
380926773,554,15,receive,374506484,6420289
380927486,900,6,receive,374482768,6444718
380928044,596,3,receive,374380430,6547614
380928462,924,8,receive,374538485,6389977
380928879,28,9,receive,374414449,6514430
380929432,846,5,receive,374520900,6408532
380930322,288,9,receive,374857297,6073025
380930722,704,8,receive,375083948,5846774
380931152,548,9,receive,374903361,6027791
381055551,710,5,receive,374696434,6359117
381055986,94,7,receive,374900212,6155774
381056546,404,8,receive,374846598,6209948
381056964,750,10,receive,374883059,6173905
381057399,800,8,receive,374869896,6187503
381057808,284,10,receive,374880581,6177227
381058268,722,6,receive,374860720,6197548
381058715,226,10,receive,374845252,6213463
381059131,800,9,receive,375129046,5930085
381059575,618,19,receive,375002494,6057081
381059990,500,8,receive,375117957,5942033
381060430,152,13,receive,375159881,5900549
381191906,390,10,receive,375153406,6038500
381192348,618,20,receive,375317654,5874694
381192902,234,8,receive,375113127,6079775
381193317,226,11,receive,375109278,6084039
381193762,248,9,receive,375128210,6065552
381194175,794,8,receive,375103756,6090419
381194604,794,9,receive,375320166,5874438
381195070,812,7,receive,374966285,6228785
381195483,740,10,receive,374995580,6199903
381196000,548,13,receive,375557695,5638305
381196722,172,10,receive,375346914,5849808
381310577,390,11,receive,375345499,5965078
381311052,384,12,receive,375350948,5960104
381311645,84,13,receive,375559008,5752637
381312087,982,23,receive,375369326,5942761
381312609,826,9,receive,375351686,5960923
381313009,28,12,receive,375123152,6189857
381313423,94,9,receive,375346645,5966778
381313979,912,12,receive,375613570,5700409
381314413,384,13,receive,375597858,5716555
381314840,816,15,receive,375609039,5705801
381315268,538,11,receive,375529409,5785859
381405069,500,10,receive,375587556,5817513
381405751,606,28,receive,375575722,5830029
381406784,692,13,receive,375620143,5786641
381407352,84,14,receive,375583033,5824319
381407826,220,9,receive,375537432,5870394
381408355,426,14,receive,375470593,5937762
381408776,220,10,receive,375817285,5591491
381409352,634,17,receive,375753328,5656024
381409794,452,14,receive,375862205,5547589
381410324,738,12,receive,375866150,5544174
381410733,430,12,receive,375855352,5555381
381411166,84,15,receive,375835837,5575329
381411585,890,8,receive,375837707,5573878
381499556,84,16,receive,376057625,5441931
381499993,56,13,receive,375849776,5650217
381500610,794,12,receive,375829942,5670668
381501106,528,13,receive,376099191,5401915
381501855,706,10,receive,376078768,5423087
381502367,368,20,receive,376091729,5410638
381502795,890,9,receive,376062957,5439838
381503224,572,15,receive,376102508,5400716
381503641,338,14,receive,376105180,5398461
381504061,616,15,receive,376077071,5426990
381504556,192,15,receive,376115029,5389527
381580645,488,19,receive,376085029,5495616
381581128,192,16,receive,376358481,5222647
381581740,134,14,receive,376359621,5222119
381582153,706,11,receive,376339491,5242662
381582556,890,10,receive,376331280,5251276
381582959,102,15,receive,376331633,5251326
381583423,134,15,receive,376547264,5036159
381583845,650,14,receive,376311942,5271903
381584265,524,23,receive,376299151,5285114
381584677,504,15,receive,376352953,5231724
381585096,390,15,receive,376275613,5309483
381648453,62,17,receive,376363608,5284845
381648943,226,16,receive,376337176,5311767
381650120,870,12,receive,376593132,5056988
381650561,386,18,receive,376615281,5035280
381651087,408,25,receive,376620753,5030334
381651657,26,20,receive,376595879,5055778
381652198,996,15,receive,376614562,5037636
381652983,972,25,receive,376613121,5039862
381733291,656,21,receive,376610912,5122379
381733852,54,22,receive,376596737,5137115
381734297,280,15,receive,376591390,5142907
381734752,660,19,receive,376603561,5131191
381735186,926,18,receive,376596792,5138394
381735618,760,14,receive,376589408,5146210
381736054,526,16,receive,376855833,4880221
381736538,154,18,receive,376872558,4863980
381736975,886,19,receive,376877403,4859572
381737389,930,17,receive,376869123,4868266
381737803,108,18,receive,376887181,4850622
381807940,854,21,receive,376864027,4943913
381808536,20,20,receive,376876970,4931566
381809119,838,15,receive,376823711,4985408
381809546,38,20,receive,376848498,4961048
381809966,256,22,receive,376865897,4944069
381810400,540,19,receive,376864204,4946196
381810804,396,16,receive,377097256,4713548
381811275,368,24,receive,377075231,4736044
381811705,498,25,receive,377136399,4675306
381812130,802,21,receive,377142041,4670089
381879937,616,19,receive,377111222,4768715
381880443,786,22,receive,377134168,4746275
381881171,662,22,receive,377133527,4747644
381882632,242,16,receive,377132034,4750598
381883121,152,21,receive,377107943,4775178
381883627,850,15,receive,377156325,4727302
381884043,708,21,receive,377106492,4777551
381884452,860,19,receive,377360231,4524221
381884888,352,20,receive,377328695,4556193
381885341,930,20,receive,377550004,4335337
381970240,498,26,receive,377367766,4602474
381970670,850,16,receive,377368920,4601750
381971209,810,23,receive,377396132,4575077
381971603,276,18,receive,377351243,4620360
381971983,618,29,receive,377309527,4662456
381972371,600,19,receive,377347724,4624647
381972756,592,28,receive,377350659,4622097
381973182,540,21,receive,377357315,4615867
381973858,142,17,receive,377344707,4629151
381974267,476,20,receive,377613992,4360275
381974702,840,27,receive,377614796,4359906
382068986,588,15,receive,377622026,4446960
382069814,382,23,receive,377636186,4433628
382070702,244,14,receive,377232031,4838671
382071244,594,29,receive,377809624,4261620
382071878,768,22,receive,377603102,4468776
382072492,382,24,receive,377810442,4262050
382073342,440,17,receive,377584344,4488998
382152461,620,22,receive,377600013,4552448
382152914,98,21,receive,377578793,4574121
382153628,370,20,receive,377611675,4541953
382154038,118,22,receive,377868623,4285415
382154949,434,26,receive,377880683,4274266
382155430,998,14,receive,377848344,4307086
382155879,426,22,receive,377390592,4765287
382156318,722,20,receive,377878502,4277816
382156735,148,18,receive,378060759,4095976
382157139,104,27,receive,377829980,4327159
382235270,558,21,receive,377880215,4355055
382235725,282,24,receive,377862636,4373089
382236332,520,24,receive,377876361,4359971
382236753,56,22,receive,378080216,4156537
382237170,856,21,receive,378113626,4123544
382237587,548,25,receive,378126275,4111312
382237996,418,29,receive,378123336,4114660
382238525,260,14,receive,378090780,4147745
382238976,172,24,receive,378132823,4106153
382239449,796,23,receive,378124225,4115224
382239986,8,26,receive,378161273,4078713
382309355,104,28,receive,378070921,4238434
382309819,648,21,receive,378339834,3969985
382310421,952,21,receive,378302544,4007877
382310853,374,21,receive,378379376,3931477
382311292,896,25,receive,378325893,3985399
382311714,172,25,receive,378358354,3953360
382312174,948,20,receive,378350171,3962003
382312575,940,22,receive,378128762,4183813
382312970,818,25,receive,378323150,3989820
382313402,534,24,receive,378370194,3943208
382313814,446,22,receive,378301045,4012769
382314275,38,26,receive,378317012,3997263
382314674,952,22,receive,378525981,3788693
382370554,350,23,receive,378499082,3871472
382370985,912,26,receive,378560716,3810269
382371526,804,38,receive,378567527,3803999
382371925,480,21,receive,378544260,3827665
382372436,282,27,receive,378518323,3854113
382372840,298,24,receive,378553707,3819133
382373281,852,31,receive,378560630,3812651
382373768,104,30,receive,378533002,3840766
382374274,282,28,receive,378713493,3660781
382374884,884,26,receive,378747278,3627606
382375335,746,32,receive,378756135,3619200
382415954,808,29,receive,378740668,3675286
382416551,104,31,receive,378761725,3654826
382417116,88,27,receive,378744371,3672745
382417598,458,28,receive,378748195,3669403
382418010,418,33,receive,378742356,3675654
382418461,796,26,receive,378745503,3672958
382418871,418,34,receive,378913848,3505023
382419466,678,34,receive,378760678,3658788
382420633,446,24,receive,378759283,3661350
382421130,716,28,receive,378964601,3456529
382421588,272,28,receive,378924853,3496735
382422007,204,29,receive,378944454,3477553
382422540,458,29,receive,378925011,3497529
382423040,446,25,receive,378924409,3498631
382423484,862,28,receive,378972655,3450829
382464592,652,27,receive,378937999,3526593
382465057,10,28,receive,378964590,3500467
382465547,866,23,receive,378935768,3529779
382466342,446,26,receive,379117055,3349287
382467013,658,27,receive,378960009,3507004
382467489,568,25,receive,379142095,3325394
382467940,542,22,receive,379164743,3303197
382468511,962,27,receive,379131384,3337127
382468951,60,27,receive,379155328,3313623
382469510,306,28,receive,379165368,3304142
382509902,380,26,receive,379164880,3345022
382510465,120,28,receive,379164421,3346044
382511128,708,31,receive,379141457,3369671
382511651,458,30,receive,379137461,3374190
382512399,78,32,receive,379147496,3364903
382513867,154,30,receive,379146902,3366965
382514282,588,25,receive,379379711,3134571
382514687,938,30,receive,379349362,3165325
382515121,716,30,receive,379353283,3161838
382567197,876,29,receive,379393633,3173564
382567634,712,33,receive,379384293,3183341
382568186,392,27,receive,379384618,3183568
382568606,896,30,receive,379364276,3204330
382569046,370,29,receive,379339721,3229325
382569475,264,35,receive,379372065,3197410
382569894,272,30,receive,379362686,3207208
382570468,820,27,receive,379356421,3214047
382570900,478,41,receive,379533312,3037588
382571325,940,28,receive,379523476,3047849
382571744,692,34,receive,379578465,2993279
382572197,264,36,receive,379532029,3040168
382572612,182,30,receive,379536637,3035975
382573139,400,34,receive,379536309,3036830
382627190,22,33,receive,379506727,3120463
382627673,182,31,receive,379662793,2964880
382628197,708,33,receive,379509005,3119192
382628609,156,31,receive,379527210,3101399
382629021,28,32,receive,379699614,2929407
382629432,688,34,receive,379728264,2901168
382629923,98,31,receive,379696605,2933318
382630362,280,31,receive,379718421,2911941
382630787,776,35,receive,379681973,2948814
382631209,666,32,receive,379739149,2892060
382631978,98,32,receive,379844172,2787806
382688669,330,34,receive,379691488,2997181
382689176,354,33,receive,379736598,2952578
382689761,400,35,receive,379684066,3005695
382690259,592,40,receive,379718758,2971501
382690768,796,32,receive,379832610,2858158
382691345,710,24,receive,379822287,2869058
382691803,24,36,receive,379865949,2825854
382692259,666,33,receive,379890606,2801653
382692755,252,40,receive,379849466,2843289
382693249,318,32,receive,379847438,2845811
382693681,278,31,receive,379874408,2819273
382694280,862,33,receive,379849508,2844772
382732326,628,37,receive,379875211,2857115
382732820,864,36,receive,379854761,2878059
382733433,602,35,receive,380134369,2599064
382733935,252,41,receive,380007608,2726327
382734422,622,25,receive,380039657,2694765
382734914,864,37,receive,380012360,2722554
382735409,24,37,receive,380002843,2732566
382735913,200,31,receive,379813938,2921975
382736404,530,33,receive,380038290,2698114
382736887,844,36,receive,379986773,2750114
382773970,140,37,receive,380020782,2753188
382774477,8,36,receive,380003149,2771328
382775075,110,39,receive,380022307,2752768
382775662,896,37,receive,380145288,2630374
382776294,564,40,receive,380147701,2628593
382776763,684,39,receive,380171640,2605123
382777223,852,44,receive,380165596,2611627
382777656,768,36,receive,380193286,2584370
382778094,746,41,receive,380168727,2609367
382778611,710,26,receive,380184886,2593725
382779043,322,34,receive,380199612,2579431
382817525,214,33,receive,380176040,2641485
382817947,354,36,receive,380200060,2617887
382818502,928,39,receive,380224100,2594402
382818943,602,37,receive,380302707,2516236
382819384,996,39,receive,380312890,2506494
382819924,504,36,receive,380341775,2478149
382820436,806,41,receive,380288190,2532246
382821014,794,38,receive,380297536,2523478
382821830,798,30,receive,380332497,2489333
382822681,764,37,receive,380307334,2515347
382823094,602,38,receive,380418146,2404948
382862818,896,38,receive,380335990,2526828
382863257,796,35,receive,380319315,2543942
382863802,356,38,receive,380451442,2412360
382864221,624,33,receive,380473136,2391085
382864674,152,39,receive,380450576,2414098
382865092,602,39,receive,380430210,2434882
382865499,134,38,receive,380508470,2357029
382866001,392,37,receive,380562642,2303359
382866421,978,33,receive,380495810,2370611
382866841,316,44,receive,380475690,2391151
382867255,906,39,receive,380580167,2287088
382905174,358,46,receive,380580841,2324333
382905649,762,44,receive,380610346,2295303
382906238,398,36,receive,380569027,2337211
382907017,498,46,receive,380618501,2288516
382907593,316,45,receive,380603397,2304196
382908131,564,43,receive,380602840,2305291
382908557,808,44,receive,380606648,2301909
382908974,280,39,receive,380711394,2197580
382909390,676,36,receive,380722639,2186751
382938269,140,45,receive,380735863,2202406
382938708,104,44,receive,380736815,2201893
382939233,70,44,receive,380715715,2223518
382939645,626,38,receive,380707646,2231999
382940062,626,39,receive,380814330,2125732
382940609,226,39,receive,380721058,2219551
382941174,500,39,receive,380747862,2193312
382941595,638,35,receive,380751270,2190325
382942008,802,43,receive,380702631,2239377
382942497,78,47,receive,380837696,2104801
382942915,754,41,receive,380867962,2074953
382981544,226,40,receive,380849149,2132395
382981983,802,44,receive,380832372,2149611
382982401,878,36,receive,380862898,2119503
382982812,874,43,receive,380839071,2143741
382983283,522,44,receive,380862527,2120756
382983697,770,40,receive,380857851,2125846
382984099,624,36,receive,380826424,2157675
382984502,734,48,receive,380964595,2019907
382984995,844,45,receive,380981494,2003501
383033702,874,44,receive,380936226,2097476
383034225,74,45,receive,380966567,2067658
383034628,724,37,receive,380963682,2070946
383035029,550,41,receive,380993996,2041033
383035482,504,42,receive,380970791,2064691
383035898,634,44,receive,380972450,2063448
383036309,984,41,receive,380965432,2070877
383036724,860,40,receive,380949282,2087442
383037165,392,41,receive,380969794,2067371
383037581,326,42,receive,380994426,2043155
383038079,172,44,receive,381088092,1949987
383038557,520,47,receive,381119915,1918642
383038984,668,42,receive,381192550,1846434
383077599,242,41,receive,381115006,1962593
383078025,976,40,receive,381124870,1953155
383078565,80,43,receive,381108243,1970322
383079026,354,45,receive,381114975,1964051
383079449,318,42,receive,381114559,1964890
383079867,354,46,receive,381196268,1883599
383080299,454,42,receive,381093717,1986582
383080775,362,46,receive,381116922,1963853
383081316,502,54,receive,381218951,1862365
383081738,850,45,receive,381212763,1868975
383082168,282,46,receive,381202445,1879723
383082624,172,45,receive,381232132,1850492
383125750,990,44,receive,381218002,1907748
383126193,248,45,receive,381262938,1863255
383126607,318,43,receive,381245879,1880728
383127076,838,44,receive,381250497,1876579
383127668,642,44,receive,381236405,1891263
383128153,382,47,receive,381209443,1918710
383128579,944,41,receive,380832619,2295960
383128997,588,41,receive,381367643,1761354
383129461,192,47,receive,381382241,1747220
383129899,330,48,receive,381332860,1797039
383130335,682,52,receive,381333902,1796433
383130752,152,47,receive,381325650,1805102
383169836,858,44,receive,381373910,1795926
383170279,446,45,receive,381369096,1801183
383170913,962,43,receive,381365994,1804919
383171339,956,46,receive,381340156,1831183
383171769,124,53,receive,381351695,1820074
383172236,356,46,receive,381354017,1818219
383172753,626,44,receive,381349526,1823227
383173238,642,45,receive,381336410,1836828
383174091,996,50,receive,381458130,1715961
383174529,564,51,receive,381444713,1729816
383217437,722,44,receive,381417088,1800349
383218260,668,47,receive,381466063,1752197
383219309,358,55,receive,381406712,1812597
383219745,858,45,receive,381439562,1780183
383220201,726,46,receive,381408853,1811348
383220642,762,51,receive,381406179,1814463
383221124,152,48,receive,381442313,1778811
383221633,124,54,receive,381451750,1769883
383222069,626,45,receive,381456070,1765999
383222504,242,45,receive,381509792,1712712
383223025,858,46,receive,381538462,1684563
383223441,274,44,receive,381555086,1668355
383223843,930,48,receive,381541685,1682158
383224250,796,48,receive,381536454,1687796
383253536,932,46,receive,381537716,1715820
383253962,668,48,receive,381540202,1713760
383254398,672,51,receive,381546193,1708205
383254815,626,46,receive,381530756,1724059
383255263,564,52,receive,381535493,1719770
383255697,668,49,receive,381585958,1669739
383256250,418,57,receive,381614963,1641287
383256759,22,52,receive,381606229,1650530
383257185,398,45,receive,381609771,1647414
383257610,502,58,receive,381581777,1675833
383258020,858,47,receive,381621536,1636484
383258460,330,51,receive,381594469,1663991
383275300,960,49,receive,381453368,1821932
383277253,154,51,receive,381601248,1676005
383279800,790,57,receive,381659997,1619803
383281135,946,53,receive,381663404,1617731
383283062,668,51,receive,381697571,1585491
383284837,502,59,receive,381656162,1628675
383286491,796,50,receive,381667876,1618615
383288386,124,57,receive,381705063,1583323
383290443,362,52,receive,381680020,1610423
383292195,676,46,receive,381712359,1579836
383293663,964,57,receive,381675722,1617941
383295048,380,50,receive,381696072,1598976
383296433,418,58,receive,381667780,1628653
383297614,364,48,receive,381761220,1536394
383299104,70,56,receive,381778017,1521087
383300424,38,52,receive,381774484,1525940
383301746,796,51,receive,381779750,1521996
383303630,676,47,receive,381772430,1531200
383304827,908,55,receive,381748976,1555851
383306675,994,50,receive,381755661,1551014
383307974,512,46,receive,381763173,1544801
383309479,946,54,receive,381745341,1564138
383310887,446,52,receive,381780817,1530070
383312424,70,57,receive,381833559,1478865
383313918,978,47,receive,381828625,1485293
383315447,708,55,receive,381821078,1494369
383316975,446,53,receive,381861024,1455951
383318053,842,53,receive,381852174,1465879
383319939,358,60,receive,381830011,1489928
383321219,124,59,receive,381809033,1512186
383324721,338,49,receive,381806195,1518526
383326486,80,52,receive,381850670,1475816
383327670,684,56,receive,381885699,1441971
383329012,954,52,receive,381969670,1359342
383329800,120,52,receive,381917537,1412263
383330769,280,52,receive,381941581,1389188
383331374,298,52,receive,381909018,1422356
383332601,210,62,receive,381918546,1414055
383333470,498,58,receive,381896422,1437048
383334532,330,55,receive,381913722,1420810
383335180,192,55,receive,381922649,1412531
383335686,512,48,receive,381938969,1396717
383336212,588,47,receive,381910698,1425514
383336892,564,59,receive,382005904,1330988
383337454,286,54,receive,382012370,1325084
383338167,522,58,receive,381996731,1341436
383338925,340,54,receive,382007777,1331148
383339472,136,57,receive,382023109,1316363
383339972,264,60,receive,381998326,1341646
383340454,490,54,receive,382041313,1299141
383340963,790,61,receive,382033707,1307256
383341505,62,59,receive,382019754,1321751
383342060,398,51,receive,382101109,1240951
383342623,676,52,receive,382090020,1252603
383343346,20,59,receive,382122065,1221281
383343785,550,56,receive,382102529,1241256
383344222,418,63,receive,382106614,1237608
383344648,802,58,receive,382105359,1239289
383345186,802,59,receive,382161263,1183923
383345644,274,51,receive,382105093,1240551
383346084,670,65,receive,382123612,1222472
383346542,790,63,receive,382153636,1192906
383347126,418,64,receive,382197927,1149199
383347533,354,59,receive,382205677,1141856
383348093,20,60,receive,382193645,1154448
383348550,494,52,receive,382204128,1144422
383348980,802,60,receive,382204752,1144228
383349422,572,58,receive,382193787,1155635
383349840,490,56,receive,382194393,1155447
383350350,886,60,receive,382216220,1134130
383350780,398,52,receive,382194169,1156611
383351198,572,59,receive,382244238,1106960
383351704,62,61,receive,382275816,1075888
383352129,248,59,receive,382288560,1063569
383352584,520,62,receive,382271143,1081441
383353078,490,57,receive,382292577,1060501
383353585,266,64,receive,382288789,1064796
383353851,786,61,receive,382277065,1076786
383354105,728,57,receive,382275274,1078831
383354361,996,62,receive,382283718,1070643
383354640,684,61,receive,382276396,1078244
383354908,398,53,receive,382295056,1059852
383355171,214,56,receive,382257436,1097735
383355546,650,56,receive,382281077,1074469
383355929,34,61,receive,382271894,1084035
383356331,762,61,receive,382311339,1044992
383356752,340,59,receive,382371405,985347
383357207,932,57,receive,382343236,1013971
383357622,286,58,receive,382353282,1004340
383357986,886,63,receive,382366928,991058
383358271,932,58,receive,382373587,984684
383358525,364,56,receive,382356009,1002516
383358793,264,65,receive,382374397,984396
383359068,850,64,receive,382370474,988594
383359320,834,55,receive,382322218,1037102
383359684,612,68,receive,382375238,984446
383359953,932,59,receive,382416645,943308
383360229,280,58,receive,382380638,979591
383360495,318,54,receive,382384628,975867
383360756,716,59,receive,382416471,944285
383361016,996,64,receive,382416062,944954
383361356,374,56,receive,382419751,941605
383361607,156,63,receive,382417722,943885
383361858,340,60,receive,382399634,962224
383362108,264,66,receive,382418135,943973
383362356,850,66,receive,382419166,943190
383362605,612,69,receive,382385892,976713
383362855,364,58,receive,382416728,946127
383363122,886,65,receive,382421636,941486
383363369,834,56,receive,382406820,956549
383363638,62,63,receive,382414299,949339
