receive_timestamp,source_vehicle,message_id,event_type,send_timestamp,latency_us
262794753861,824,1,receive,262794709244,44617
262794754434,818,1,receive,262794710825,43609
262794754964,552,1,receive,262794712774,42190
262794755429,752,1,receive,262794715035,40394
262794755883,274,1,receive,262794718059,37824
262794756438,830,1,receive,262794719284,37154
262794756989,480,1,receive,262794719296,37693
262794835672,822,1,receive,262794719860,115812
262794836096,618,1,receive,262794721795,114301
262794836484,520,1,receive,262794730338,106146
262794836858,630,1,receive,262794730659,106199
262794837250,500,1,receive,262794731099,106151
262794837627,526,1,receive,262794732762,104865
262794838016,348,1,receive,262794733707,104309
262794889828,508,1,receive,262794734772,155056
262794924456,836,1,receive,262794737218,187238
262794924884,792,1,receive,262794738039,186845
262794925313,762,1,receive,262794738054,187259
262794925717,820,1,receive,262794738579,187138
262794926137,168,1,receive,262794739068,187069
262794947251,454,1,receive,262794739055,208196
262794947636,354,1,receive,262794739204,208432
262795005063,840,1,receive,262794739718,265345
262795005491,388,1,receive,262794699467,306024
262795005928,488,1,receive,262794741721,264207
262795006374,92,1,receive,262794651844,354530
262795006795,816,1,receive,262794745511,261284
262795007232,202,1,receive,262794745539,261693
262795007653,244,1,receive,262794745732,261921
262795066119,212,1,receive,262794749217,316902
262795066546,432,1,receive,262794657302,409244
262795066963,178,1,receive,262794679202,387761
262795067395,352,1,receive,262794747193,320202
262795067814,610,1,receive,262794753207,314607
262795068247,634,1,receive,262794756062,312185
262795068674,540,1,receive,262794759061,309613
262795069114,786,1,receive,262794759277,309837
262795069551,494,1,receive,262794759442,310109
262795069972,482,1,receive,262794759783,310189
262795151449,838,1,receive,262794760973,390476
262795151880,736,1,receive,262794761059,390821
262795152309,712,1,receive,262794765916,386393
262795152728,606,1,receive,262794767049,385679
262795153154,594,1,receive,262794771037,382117
262795153576,62,1,receive,262794771460,382116
262795153991,236,1,receive,262794669024,484967
262795154425,356,1,receive,262794775038,379387
262795154843,724,1,receive,262794775084,379759
262795235649,722,1,receive,262794775712,459937
262795236102,788,1,receive,262794776734,459368
262795236541,638,1,receive,262794777049,459492
262795236967,466,1,receive,262794779063,457904
262795237409,754,1,receive,262794779855,457554
262795237843,744,1,receive,262794782098,455745
262795286483,718,1,receive,262794784101,502382
262795286917,58,1,receive,262794634580,652337
262795321092,852,1,receive,262794785938,535154
262795321513,842,1,receive,262794787098,534415
262795321924,140,1,receive,262794705034,616890
262795322368,874,1,receive,262794790712,531656
262795347982,608,1,receive,262794791047,556935
262795365331,740,1,receive,262794791185,574146
262795365771,862,1,receive,262794791404,574367
262795414172,586,1,receive,262794773034,641138
262795414609,680,1,receive,262794800964,613645
262795415058,556,1,receive,262794801210,613848
262795415499,80,1,receive,262794753077,662422
262795415937,810,1,receive,262794800687,615250
262795416385,682,1,receive,262794803273,613112
262795416816,848,1,receive,262794804357,612459
262795500618,688,1,receive,262794805146,695472
262795501053,670,1,receive,262794805425,695628
262795501489,706,1,receive,262794805754,695735
262795519730,532,1,receive,262794804039,715691
262795536036,866,1,receive,262794807290,728746
262795536465,846,1,receive,262794808433,728032
262795536909,700,1,receive,262794808661,728248
262795594862,666,1,receive,262794808832,786030
262795595459,726,1,receive,262794809152,786307
262795595896,886,1,receive,262794809654,786242
262795596344,280,1,receive,262794804038,792306
262795596790,534,1,receive,262794810019,786771
262795597244,742,1,receive,262794810046,787198
262795597686,734,1,receive,262794805975,791711
262795687462,738,1,receive,262794804564,882898
262795687903,578,1,receive,262794813571,874332
262795688372,614,1,receive,262794818064,870308
262795688811,766,1,receive,262794818592,870219
262795689268,814,1,receive,262794819547,869721
262795689709,760,1,receive,262794820818,868891
262795690159,620,1,receive,262794817830,872329
262795782192,864,1,receive,262794816273,965919
262795782629,612,1,receive,262794824582,958047
262795783068,768,1,receive,262794826059,957009
262795783507,472,1,receive,262794824203,959304
262795783939,890,1,receive,262794828041,955898
262795824039,902,1,receive,262794828444,995595
262795824489,878,1,receive,262794829373,995116
262795824927,558,1,receive,262794826751,998176
262795885683,882,1,receive,262794827769,1057914
262795886111,730,1,receive,262794831114,1054997
262795886533,780,1,receive,262794831798,1054735
262795886959,32,1,receive,262794664030,1222929
262795887404,174,1,receive,262794707028,1180376
262795887837,538,1,receive,262794831395,1056442
262795888291,774,1,receive,262794834551,1053740
262795888740,782,1,receive,262794831156,1057584
262796011551,636,1,receive,262794835757,1175794
262796011990,230,1,receive,262794836017,1175973
262796012444,568,1,receive,262794828903,1183541
262796013559,276,1,receive,262794718788,1294771
262796013997,184,1,receive,262794837518,1176479
262796014447,888,1,receive,262794838015,1176432
262796014881,708,1,receive,262794823509,1191372
262796015326,704,1,receive,262794836511,1178815
262796015763,536,1,receive,262794827439,1188324
262796216242,884,1,receive,262794818675,1397567
262796216676,880,1,receive,262794828803,1387873
262796217125,856,1,receive,262794841630,1375495
262796217587,674,1,receive,262794842731,1374856
262796218046,678,1,receive,262794849031,1369015
262796218504,868,1,receive,262794833809,1384695
262796218958,698,1,receive,262794848604,1370354
262796307540,806,1,receive,262794853081,1454459
262796307992,778,1,receive,262794855512,1452480
262796308456,720,1,receive,262794843242,1465214
262796308908,844,1,receive,262794842017,1466891
262796309375,900,1,receive,262794839300,1470075
262796309828,464,1,receive,262794827781,1482047
262796310293,804,1,receive,262794860983,1449310
262796310741,444,1,receive,262794861645,1449096
262796446150,790,1,receive,262794850137,1596013
262796446608,896,1,receive,262794858653,1587955
262796447069,870,1,receive,262794831029,1616040
262796447532,912,1,receive,262794858038,1589494
262796452522,116,1,receive,262794852130,1600392
262796452982,716,1,receive,262794853883,1599099
262796453453,876,1,receive,262794852260,1601193
262796453907,732,1,receive,262794852037,1601870
262796545386,854,1,receive,262794864460,1680926
262796545846,914,1,receive,262794874858,1670988
262796546317,828,1,receive,262794871988,1674329
262796546767,910,1,receive,262794873486,1673281
262796547229,892,1,receive,262794863422,1683807
262796547686,600,1,receive,262794874615,1673071
262796627162,124,2,receive,262794780600,1846562
262796627735,924,1,receive,262794879157,1748578
262796628216,918,1,receive,262794884191,1744025
262796628686,858,1,receive,262794875062,1753624
262796629166,628,2,receive,262794887482,1741684
262796629627,222,1,receive,262794858074,1771553
262796711103,826,1,receive,262794888886,1822217
262796711554,908,1,receive,262794887953,1823601
262796711981,916,1,receive,262794895909,1816072
262796712422,898,1,receive,262794897612,1814810
262796712866,206,1,receive,262794894084,1818782
262796713347,906,1,receive,262794896323,1817024
262796713796,176,1,receive,262794885163,1828633
262796817178,850,1,receive,262794880639,1936539
262796817666,702,1,receive,262794859037,1958629
262796818157,920,1,receive,262794906037,1912120
262796818631,904,1,receive,262794898967,1919664
262796819108,104,1,receive,262794693040,2126068
262796819581,894,1,receive,262794910035,1909546
262796898523,714,1,receive,262794869932,2028591
262796899007,432,2,receive,262794897567,2001440
262796899489,362,1,receive,262794890412,2009077
262796899956,74,2,receive,262794891949,2008007
262796900430,138,1,receive,262794906230,1994200
262796900899,872,1,receive,262794868647,2032252
262796901373,926,1,receive,262794922243,1979130
262796901838,860,1,receive,262794864783,2037055
262797014351,928,1,receive,262794926348,2088003
262797014822,922,1,receive,262794927383,2087439
262797015312,442,2,receive,262794921009,2094303
262797015783,172,1,receive,262794871811,2143972
262797016263,152,1,receive,262794921274,2094989
262797016733,820,2,receive,262794926445,2090288
262797017210,562,1,receive,262794948009,2069201
262797017681,378,1,receive,262794945663,2072018
262797154375,114,1,receive,262794899455,2254920
262797154826,758,2,receive,262794953280,2201546
262797155305,110,2,receive,262794921860,2233445
262797155770,148,1,receive,262794843310,2312460
262797156252,772,1,receive,262794960625,2195627
262797156714,212,2,receive,262794923249,2233465
262797157193,354,2,receive,262794884812,2272381
262797157658,938,1,receive,262794965518,2192140
262797287083,736,2,receive,262794901012,2386071
262797287550,934,1,receive,262794966837,2320713
262797288036,580,2,receive,262794955918,2332118
262797288503,888,2,receive,262794981489,2307014
262797288960,956,1,receive,262794984049,2304911
262797289427,508,2,receive,262794961472,2327955
262797289882,262,2,receive,262794986507,2303375
262797387574,962,1,receive,262794987230,2400344
262797388027,220,1,receive,262794979264,2408763
262797388505,838,2,receive,262794990251,2398254
262797388970,930,1,receive,262794990426,2398544
262797389447,700,2,receive,262794990760,2398687
262797389909,418,1,receive,262794895366,2494543
262797390417,12,2,receive,262794920545,2469872
262797390882,958,1,receive,262794999239,2391643
262797509353,964,1,receive,262795001085,2508268
262797509832,954,1,receive,262795002131,2507701
262797510326,948,1,receive,262795005276,2505050
262797510801,950,1,receive,262795006730,2504071
262797511285,944,1,receive,262795008940,2502345
262797511754,952,1,receive,262795010977,2500777
262797608073,358,2,receive,262795011078,2596995
262797608542,942,1,receive,262795012579,2595963
262797609012,20,2,receive,262794917166,2691846
262797609478,946,1,receive,262795013041,2596437
262797609945,404,1,receive,262795004819,2605126
262797610418,960,1,receive,262795017037,2593381
262797610876,162,2,receive,262795004120,2606756
262797698783,586,2,receive,262795027329,2671454
262797699305,98,2,receive,262794964568,2734737
262797699752,940,1,receive,262795036121,2663631
262797700203,210,2,receive,262794982172,2718031
262797700640,78,2,receive,262795022226,2678414
262797701088,830,2,receive,262794976027,2725061
262797701538,422,2,receive,262794986217,2715321
262797701977,132,2,receive,262794906265,2795712
262797817473,160,2,receive,262795016847,2800626
262797817921,918,2,receive,262795049131,2768790
262797818383,794,2,receive,262795023196,2795187
262797818827,112,2,receive,262795056133,2762694
262797819284,976,1,receive,262795073341,2745943
262797819727,932,1,receive,262795063596,2756131
262797820180,364,2,receive,262795067571,2752609
262797820640,982,1,receive,262795079056,2741584
262797937762,984,1,receive,262795081846,2855916
262797938233,276,2,receive,262795039009,2899224
262797938689,520,2,receive,262795005006,2933683
262797939153,532,2,receive,262794950393,2988760
262797939608,858,2,receive,262795060530,2879078
262797940069,50,2,receive,262795070087,2869982
262797940532,534,2,receive,262795001570,2938962
262797940985,366,2,receive,262795001827,2939158
262798053419,902,2,receive,262795074010,2979409
262798053854,768,2,receive,262795088944,2964910
262798054292,142,2,receive,262795092212,2962080
262798054713,834,2,receive,262795077081,2977632
262798055150,972,1,receive,262795096706,2958444
262798055580,26,2,receive,262795026885,3028695
262798157568,88,2,receive,262795033006,3124562
262798158056,970,1,receive,262795098258,3059798
262798158517,568,2,receive,262795021119,3137398
262798158975,380,2,receive,262795017297,3141678
262798159450,988,1,receive,262795103063,3056387
262798159911,488,2,receive,262794998425,3161486
262798160390,536,2,receive,262795056071,3104319
262798160849,968,1,receive,262795108099,3052750
262798284343,974,1,receive,262795108579,3175764
262798284799,986,1,receive,262795109127,3175672
262798285277,980,1,receive,262795113334,3171943
262798285741,178,2,receive,262795086010,3199731
262798286210,996,1,receive,262795116543,3169667
262798286677,886,2,receive,262795051291,3235386
262798408228,82,2,receive,262795037400,3370828
262798408700,966,1,receive,262795122559,3286141
262798409177,382,1,receive,262795125558,3283619
262798409639,494,2,receive,262795094268,3315371
262798410110,952,2,receive,262795130580,3279530
262798410571,978,1,receive,262795121129,3289442
262798411040,994,1,receive,262795136986,3274054
262798411496,52,2,receive,262795086293,3325203
262798411957,992,1,receive,262795141061,3270896
262798551455,556,2,receive,262795067005,3484450
262798551921,998,1,receive,262795151122,3400799
262798552398,990,1,receive,262795143046,3409352
262798552869,134,2,receive,262795112506,3440363
262798553346,384,2,receive,262795049007,3504339
262798553807,120,2,receive,262795115113,3438694
262798655468,42,2,receive,262794953452,3702016
262798655921,594,2,receive,262795128109,3527812
262798656416,372,2,receive,262795117342,3539074
262798656889,936,1,receive,262795163022,3493867
262798657371,166,2,receive,262795160380,3496991
262798657841,274,2,receive,262795127683,3530158
262798658327,164,2,receive,262795098347,3559980
262798658801,354,3,receive,262795164104,3494697
262798792298,480,2,receive,262795083207,3709091
262798792760,64,2,receive,262795108346,3684414
262798793224,702,2,receive,262795104028,3689196
262798793672,790,2,receive,262795139013,3654659
262798794135,890,2,receive,262795181759,3612376
262798794600,848,2,receive,262795104007,3690593
262798900512,736,3,receive,262795155175,3745337
262798900981,772,2,receive,262795183574,3717407
262798901462,234,2,receive,262794962090,3939372
262798901922,150,2,receive,262795192006,3709916
262798902394,810,2,receive,262795172580,3729814
262798902850,428,2,receive,262795178010,3724840
262798903314,842,2,receive,262795157008,3746306
262799009508,538,2,receive,262795169780,3839728
262799009958,870,2,receive,262795191036,3818922
262799010420,122,2,receive,262795151020,3859400
262799010880,866,2,receive,262795217068,3793812
262799011357,244,2,receive,262795151315,3860042
262799011818,144,1,receive,262795217066,3794752
262799056430,948,2,receive,262795219572,3836858
262799056893,46,2,receive,262795174774,3882119
262799149333,60,2,receive,262795028316,4121017
262799149785,938,2,receive,262795200017,3949768
262799150274,880,2,receive,262795130518,4019756
262799150750,86,2,receive,262795156011,3994739
262799151228,722,2,receive,262795202016,3949212
262799151696,184,2,receive,262795188876,3962820
262799257717,1000,1,receive,262795235958,4021759
262799258210,778,2,receive,262795225615,4032595
262799258676,358,3,receive,262795158156,4100520
262799259154,14,2,receive,262795227167,4031987
262799259619,854,2,receive,262795025945,4233674
262799260091,62,2,receive,262795198065,4062026
262799361880,874,2,receive,262795207780,4154100
262799362366,128,2,receive,262795211230,4151136
262799362832,348,2,receive,262795126019,4236813
262799363303,236,2,receive,262795176062,4187241
262799363765,698,2,receive,262795182874,4180891
262799364271,976,2,receive,262795242365,4121906
262799364733,542,2,receive,262795202559,4162174
262799474238,34,2,receive,262795224006,4250232
262799474692,896,2,receive,262795262010,4212682
262799475204,586,3,receive,262795298077,4177127
262799475676,840,2,receive,262795288011,4187665
262799486256,940,2,receive,262795298578,4187678
262799486725,580,3,receive,262795239149,4247576
262799487203,442,3,receive,262795317101,4170102
262799487671,222,2,receive,262795262006,4225665
262799625163,356,2,receive,262795334689,4290474
262799625630,526,2,receive,262795297210,4328420
262799626106,50,3,receive,262795387475,4238631
262799626585,632,2,receive,262795398098,4228487
262799627064,344,2,receive,262795348014,4279050
262799642693,862,2,receive,262795319006,4323687
262799643157,638,2,receive,262795420640,4222517
262799643604,234,3,receive,262795361017,4282587
262799762088,422,3,receive,262795381926,4380162
262799762545,118,2,receive,262795369010,4393535
262799763011,724,2,receive,262795499152,4263859
262799763475,758,3,receive,262795409919,4353556
262799763934,964,2,receive,262795447010,4316924
262799773107,42,3,receive,262795494475,4278632
262799773548,804,2,receive,262795484006,4289542
262799864893,76,3,receive,262795473568,4391325
262799865379,838,3,receive,262795469159,4396220
262799865843,928,2,receive,262795576207,4289636
262799866329,12,3,receive,262795520504,4345825
262799866795,968,2,receive,262795525987,4340808
262799867272,358,4,receive,262795483103,4384169
262799867739,934,2,receive,262795578622,4289117
262799963243,132,3,receive,262795587556,4375687
262799963708,588,2,receive,262795586010,4377698
262799964209,28,2,receive,262795611132,4353077
262799964672,726,2,receive,262795581494,4383178
262799974587,380,3,receive,262795602080,4372507
262799994177,366,3,receive,262795617548,4376629
262799994644,72,2,receive,262795661006,4333638
262800106931,984,2,receive,262795703009,4403922
262800107399,670,3,receive,262795667006,4440393
262800107844,880,3,receive,262795736091,4371753
262800108294,70,2,receive,262795690430,4417864
262800108736,634,2,receive,262795669063,4439673
262800109196,988,2,receive,262795775093,4334103
262800109639,868,2,receive,262795779233,4330406
262800192508,454,2,receive,262795732077,4460431
262800192965,540,2,receive,262795717034,4475931
262800193427,354,5,receive,262795803308,4390119
262800193875,220,2,receive,262795775077,4418798
262800194332,936,2,receive,262795890476,4303856
262800194776,376,3,receive,262795837664,4357112
262800195239,86,4,receive,262795886361,4308878
262800195687,950,3,receive,262795823548,4372139
262800316175,288,1,receive,262795894335,4421840
262800316637,858,3,receive,262795835454,4481183
262800317111,488,3,receive,262795880005,4437106
262800317572,702,3,receive,262795948011,4369561
262800318052,140,3,receive,262795995223,4322829
262800318520,622,1,receive,262796017816,4300704
262800318977,976,3,receive,262796009550,4309427
262800319447,636,2,receive,262795923519,4395928
262800319904,856,2,receive,262795887511,4432393
262800434392,758,4,receive,262795999934,4434458
262800434840,900,3,receive,262796026714,4408126
262800435301,160,3,receive,262795936608,4498693
262800435745,582,3,receive,262796209288,4226457
262800453165,760,3,receive,262796140830,4312335
262800456963,872,3,receive,262796177849,4279114
262800457438,52,4,receive,262796148948,4308490
262800457880,866,3,receive,262796204309,4253571
262800545363,218,4,receive,262796221993,4323370
262800545805,28,4,receive,262796240449,4305356
262800546265,508,4,receive,262796252212,4294053
262800546703,788,5,receive,262796298277,4248426
262800562110,36,3,receive,262796271006,4291104
262800567076,994,4,receive,262796289469,4277607
262800630855,924,3,receive,262796279006,4351849
262800631310,394,1,receive,262796316468,4314842
262800631747,480,4,receive,262796293263,4338484
262800632220,636,3,receive,262796270706,4361514
262800632662,778,5,receive,262796429941,4202721
262800653455,230,3,receive,262796400912,4252543
262800653891,508,5,receive,262796466009,4187882
262800654325,610,3,receive,262796380853,4273472
262800654747,44,3,receive,262796419843,4234904
262800738216,794,4,receive,262796451119,4287097
262800738658,810,5,receive,262796474630,4264028
262800739109,742,3,receive,262796422005,4317104
262800739551,138,4,receive,262796502376,4237175
262800739997,592,4,receive,262796559765,4180232
262800740453,372,5,receive,262796504006,4236447
262800740905,868,3,receive,262796535962,4204943
262800741359,198,3,receive,262796259983,4481376
262800741802,352,4,receive,262796553648,4188154
262800844196,206,4,receive,262796604639,4239557
262800844624,630,3,receive,262796515741,4328883
262800845060,834,4,receive,262796536005,4309055
262800848158,838,7,receive,262796590130,4258028
262800848611,840,4,receive,262796551486,4297125
262800849061,110,5,receive,262796601580,4247481
262800849505,358,6,receive,262796634257,4215248
262800849947,106,4,receive,262796641135,4208812
262800928810,918,4,receive,262796624082,4304728
262800929270,172,3,receive,262796651879,4277391
262800929719,66,3,receive,262796720281,4209438
262800930171,716,4,receive,262796566203,4363968
262800930621,722,4,receive,262796722616,4208005
262800931072,818,5,receive,262796810010,4121062
262800931515,740,3,receive,262796776079,4155436
262801012350,880,5,receive,262796828144,4184206
262801012802,812,4,receive,262796783285,4229517
262801013287,614,4,receive,262796777376,4235911
262801013732,16,4,receive,262796803152,4210580
262801014191,734,5,receive,262796903006,4111185
262801014638,752,3,receive,262796831517,4183121
262801015093,946,3,receive,262796898078,4117015
262801015539,900,5,receive,262796873010,4142529
262801015976,634,4,receive,262796909009,4106967
262801093743,150,5,receive,262796836277,4257466
262801094205,174,5,receive,262796880220,4213985
262801094648,482,4,receive,262796888730,4205918
262801095107,592,5,receive,262796965727,4129380
262801095552,210,4,receive,262796897717,4197835
262801095988,682,5,receive,262796904278,4191710
262801096442,712,4,receive,262796913876,4182566
262801096882,582,4,receive,262796907460,4189422
262801183057,202,5,receive,262796997818,4185239
262801183502,646,2,receive,262797036005,4147497
262801183941,146,3,receive,262796899611,4284330
262801184407,876,4,receive,262797105347,4079060
262801184848,156,4,receive,262797127410,4057438
262801185299,40,4,receive,262797188968,3996331
262801185742,742,4,receive,262797093891,4091851
262801264806,640,5,receive,262797124881,4139925
262801265245,678,5,receive,262797174336,4090909
262801265668,112,5,receive,262797089005,4176663
262801266099,562,4,receive,262797071556,4194543
262801266526,372,7,receive,262797298323,3968203
262801266966,280,4,receive,262797257895,4009071
262801295034,222,4,receive,262797275014,4020020
262801295487,382,4,receive,262797139691,4155796
262801295933,26,5,receive,262797289185,4006748
262801356410,538,5,receive,262797316773,4039637
262801356854,162,6,receive,262797214717,4142137
262801357319,874,5,receive,262797362006,3995313
262801357764,208,5,receive,262797392903,3964861
262801358217,982,5,receive,262797319499,4038718
262801358660,760,6,receive,262797362755,3995905
262801359114,972,4,receive,262797300361,4058753
262801432395,12,5,receive,262797334312,4098083
262801432838,910,5,receive,262797331606,4101232
262801433290,712,5,receive,262797341824,4091466
262801433728,364,7,receive,262797458011,3975717
262801434184,116,5,receive,262797451629,3982555
262801434619,866,6,receive,262797515289,3919330
262801506079,126,4,receive,262797348141,4157938
262801506533,16,5,receive,262797453009,4053524
262801506973,654,3,receive,262797415141,4091832
262801507433,622,3,receive,262797503098,4004335
262801507883,582,5,receive,262797602415,3905468
262801508334,860,4,receive,262797480685,4027649
262801508777,138,6,receive,262797605381,3903396
262801573935,356,6,receive,262797501365,4072570
262801574374,450,5,receive,262797559020,4015354
262801574812,88,6,receive,262797557937,4016875
262801575255,402,2,receive,262797635847,3939408
262801575691,670,7,receive,262797701082,3874609
262801576138,262,7,receive,262797665005,3911133
262801576574,494,7,receive,262797666968,3909606
262801661397,562,5,receive,262797681579,3979818
262801661835,704,6,receive,262797694129,3967706
262801662275,114,5,receive,262797654863,4007412
262801662716,880,6,receive,262797720236,3942480
262801663169,152,4,receive,262797781745,3881424
262801681492,646,3,receive,262797749257,3932235
262801681941,754,6,receive,262797754007,3927934
262801682392,722,6,receive,262797831887,3850505
262801682831,174,7,receive,262797826614,3856217
262801751835,122,5,receive,262797785013,3966822
262801752302,276,5,receive,262797626222,4126080
262801752741,596,7,receive,262797742734,4010007
262801753194,76,8,receive,262797942008,3811186
262801753631,68,5,receive,262797845049,3908582
262801754076,160,5,receive,262797881887,3872189
262801754514,146,4,receive,262797800325,3954189
262801826056,142,6,receive,262797898026,3928030
262801826498,862,5,receive,262797861125,3965373
262801826954,84,5,receive,262797930028,3896926
262801827413,610,5,receive,262797932248,3895165
262801827855,198,5,receive,262798086203,3741652
262801855034,476,6,receive,262798034419,3820615
262801902651,578,7,receive,262798074574,3828077
262801903126,234,7,receive,262798155265,3747861
262801903568,344,7,receive,262798145665,3757903
262801904014,82,6,receive,262798037356,3866658
262801904459,818,7,receive,262798100012,3804447
262801904899,862,6,receive,262798150640,3754259
262801905348,866,8,receive,262798178791,3726557
262801905791,184,8,receive,262798180788,3725003
262801984494,42,8,receive,262798090581,3893913
262801984936,982,7,receive,262798176814,3808122
262801985389,76,9,receive,262798165782,3819607
262801985827,778,7,receive,262798125924,3859903
262801986289,820,7,receive,262798244393,3741896
262801986732,794,7,receive,262798291803,3694929
262801987181,472,6,receive,262798320357,3666824
262801987620,442,7,receive,262798296802,3690818
262802056950,58,8,receive,262798257350,3799600
262802057398,888,6,receive,262798327006,3730392
262802057812,938,7,receive,262798347954,3709858
262802058267,222,6,receive,262798280007,3778260
262802058710,918,8,receive,262798244421,3814289
262802059165,262,9,receive,262798403011,3656154
262802059599,966,5,receive,262798369377,3690222
262802120039,894,7,receive,262798406412,3713627
262802120499,792,7,receive,262798200198,3920301
262802120943,656,2,receive,262798308011,3812932
262802121400,432,7,receive,262798360189,3761211
262802121835,826,6,receive,262798457009,3664826
262802122290,926,6,receive,262798545801,3576489
262802122727,592,8,receive,262798494468,3628259
262802200332,666,6,receive,262798563008,3637324
262802200759,60,7,receive,262798527270,3673489
262802201183,184,9,receive,262798467315,3733868
262802201595,724,7,receive,262798575007,3626588
262802202039,26,8,receive,262798662012,3540027
262802202476,278,8,receive,262798570919,3631557
262802202906,702,7,receive,262798592092,3610814
262802203356,46,6,receive,262798607382,3595974
262802274570,848,7,receive,262798568131,3706439
262802275021,352,8,receive,262798666007,3609014
262802275473,678,7,receive,262798644066,3631407
262802275907,100,8,receive,262798724074,3551833
262802276356,922,7,receive,262798725487,3550869
262802276789,280,7,receive,262798742111,3534678
262802277237,68,6,receive,262798736133,3541104
262802277676,104,7,receive,262798816367,3461309
262802365165,232,4,receive,262798784149,3581016
262802365608,348,11,receive,262798895570,3470038
262802366052,742,6,receive,262798910534,3455518
262802366483,916,7,receive,262798873313,3493170
262802366916,556,8,receive,262798864476,3502440
262802381218,646,5,receive,262798897185,3484033
262802381641,888,7,receive,262798891586,3490055
262802436788,656,3,receive,262798938010,3498778
262802437222,78,11,receive,262799022855,3414367
262802437645,652,3,receive,262798906320,3531325
262802438069,558,8,receive,262798987899,3450170
262802438491,34,9,receive,262798899578,3538913
262802438926,938,9,receive,262798973011,3465915
262802457676,56,7,receive,262798983079,3474597
262802458128,794,10,receive,262799041532,3416596
262802458567,790,8,receive,262799081614,3376953
262802533874,744,8,receive,262799112012,3421862
262802534316,832,6,receive,262799102869,3431447
262802534733,220,6,receive,262799161342,3373391
262802535163,640,8,receive,262799052005,3483158
262802535599,826,8,receive,262799141032,3394567
262802536043,830,8,receive,262799133388,3402655
262802536482,398,8,receive,262799261016,3275466
262802536922,734,8,receive,262799269627,3267295
262802615495,162,9,receive,262799100131,3515364
262802615905,166,9,receive,262799218077,3397828
262802616334,890,10,receive,262799272009,3344325
262802616746,838,11,receive,262799229011,3387735
262802617174,876,8,receive,262799289007,3328167
262802617608,10,7,receive,262799359522,3258086
262802618054,886,8,receive,262799308752,3309302
262802618493,938,10,receive,262799371416,3247077
262802618924,844,7,receive,262799341990,3276934
