receive_timestamp,source_vehicle,message_id,event_type,send_timestamp,latency_us
262794861593,586,1,receive,262794773034,88559
262794862235,680,1,receive,262794800964,61271
262794862817,556,1,receive,262794801210,61607
262794863371,80,1,receive,262794753077,110294
262794863947,810,1,receive,262794800687,63260
262794864536,682,1,receive,262794803273,61263
262794959163,848,1,receive,262794804357,154806
262794959766,688,1,receive,262794805146,154620
262794960396,670,1,receive,262794805425,154971
262794961019,706,1,receive,262794805754,155265
262794961649,532,1,receive,262794804039,157610
262794962278,866,1,receive,262794807290,154988
262794962907,846,1,receive,262794808433,154474
262795067136,700,1,receive,262794808661,258475
262795067801,666,1,receive,262794808832,258969
262795068476,726,1,receive,262794809152,259324
262795069148,886,1,receive,262794809654,259494
262795152341,280,1,receive,262794804038,348303
262795152995,534,1,receive,262794810019,342976
262795153653,742,1,receive,262794810046,343607
262795167300,734,1,receive,262794805975,361325
262795167950,738,1,receive,262794804564,363386
262795168614,578,1,receive,262794813571,355043
262795276991,614,1,receive,262794818064,458927
262795277665,766,1,receive,262794818592,459073
262795278329,814,1,receive,262794819547,458782
262795278999,760,1,receive,262794820818,458181
262795327454,620,1,receive,262794817830,509624
262795397665,864,1,receive,262794816273,581392
262795398319,612,1,receive,262794824582,573737
262795398967,768,1,receive,262794826059,572908
262795399641,472,1,receive,262794824203,575438
262795400314,890,1,receive,262794828041,572273
262795400986,902,1,receive,262794828444,572542
262795515062,878,1,receive,262794829373,685689
262795515730,558,1,receive,262794826751,688979
262795516405,882,1,receive,262794827769,688636
262795517087,780,1,receive,262794831798,685289
262795517749,32,1,receive,262794664030,853719
262795628691,174,1,receive,262794707028,921663
262795629381,538,1,receive,262794831395,797986
262795630061,774,1,receive,262794834551,795510
262795630726,782,1,receive,262794831156,799570
262795631400,636,1,receive,262794835757,795643
262795751124,230,1,receive,262794836017,915107
262795751799,568,1,receive,262794828903,922896
262795752476,276,1,receive,262794718788,1033688
262795753148,184,1,receive,262794837518,915630
262795753810,888,1,receive,262794838015,915795
262795754488,708,1,receive,262794823509,930979
262795876544,704,1,receive,262794836511,1040033
262795877198,536,1,receive,262794827439,1049759
262795877825,884,1,receive,262794818675,1059150
262795878476,880,1,receive,262794828803,1049673
262795879132,856,1,receive,262794841630,1037502
262795879786,674,1,receive,262794842731,1037055
262795983756,678,1,receive,262794849031,1134725
262795984437,868,1,receive,262794833809,1150628
262795985101,698,1,receive,262794848604,1136497
262796008341,806,1,receive,262794853081,1155260
262796087297,778,1,receive,262794855512,1231785
262796087951,720,1,receive,262794843242,1244709
262796088609,844,1,receive,262794842017,1246592
262796089265,900,1,receive,262794839300,1249965
262796089921,464,1,receive,262794827781,1262140
262796188283,804,1,receive,262794860983,1327300
262796188938,444,1,receive,262794861645,1327293
262796189613,790,1,receive,262794850137,1339476
262796190294,896,1,receive,262794858653,1331641
262796190954,870,1,receive,262794831029,1359925
262796191631,912,1,receive,262794858038,1333593
262796308536,116,1,receive,262794852130,1456406
262796309207,716,1,receive,262794853883,1455324
262796309869,876,1,receive,262794852260,1457609
262796310522,732,1,receive,262794852037,1458485
262796311179,854,1,receive,262794864460,1446719
262796426260,914,1,receive,262794874858,1551402
262796426938,828,1,receive,262794871988,1554950
262796427619,910,1,receive,262794873486,1554133
262796428297,892,1,receive,262794863422,1564875
262796428972,600,1,receive,262794874615,1554357
262796429658,124,2,receive,262794780600,1649058
262796551849,924,1,receive,262794879157,1672692
262796552530,918,1,receive,262794884191,1668339
262796553205,858,1,receive,262794875062,1678143
262796553864,628,2,receive,262794887482,1666382
262796554540,222,1,receive,262794858074,1696466
262796665489,826,1,receive,262794888886,1776603
262796666187,908,1,receive,262794887953,1778234
262796666822,916,1,receive,262794895909,1770913
262796667498,898,1,receive,262794897612,1769886
262796668176,206,1,receive,262794894084,1774092
262796668849,906,1,receive,262794896323,1772526
262796789549,176,1,receive,262794885163,1904386
262796790247,850,1,receive,262794880639,1909608
262796790896,702,1,receive,262794859037,1931859
262796791535,920,1,receive,262794906037,1885498
262796792193,904,1,receive,262794898967,1893226
262796792843,104,1,receive,262794693040,2099803
262796915889,894,1,receive,262794910035,2005854
262796916570,714,1,receive,262794869932,2046638
262796917254,432,2,receive,262794897567,2019687
262796917926,362,1,receive,262794890412,2027514
262796918601,74,2,receive,262794891949,2026652
262797044314,138,1,receive,262794906230,2138084
262797044986,872,1,receive,262794868647,2176339
262797045659,926,1,receive,262794922243,2123416
262797046325,860,1,receive,262794864783,2181542
262797046976,928,1,receive,262794926348,2120628
262797149648,922,1,receive,262794927383,2222265
262797150312,442,2,receive,262794921009,2229303
262797150959,172,1,receive,262794871811,2279148
262797188318,152,1,receive,262794921274,2267044
262797250364,820,2,receive,262794926445,2323919
262797251055,562,1,receive,262794948009,2303046
262797251945,378,1,receive,262794945663,2306282
262797252613,114,1,receive,262794899455,2353158
262797253289,758,2,receive,262794953280,2300009
262797253951,110,2,receive,262794921860,2332091
262797391667,148,1,receive,262794843310,2548357
262797392358,772,1,receive,262794960625,2431733
262797393048,212,2,receive,262794923249,2469799
262797393741,354,2,receive,262794884812,2508929
262797502144,938,1,receive,262794965518,2536626
262797502832,736,2,receive,262794901012,2601820
262797503515,934,1,receive,262794966837,2536678
262797504209,580,2,receive,262794955918,2548291
262797504900,888,2,receive,262794981489,2523411
262797605334,956,1,receive,262794984049,2621285
262797606015,508,2,receive,262794961472,2644543
262797606705,262,2,receive,262794986507,2620198
262797607406,962,1,receive,262794987230,2620176
262797718337,220,1,receive,262794979264,2739073
262797719040,838,2,receive,262794990251,2728789
262797719734,930,1,receive,262794990426,2729308
262797720413,700,2,receive,262794990760,2729653
262797721094,418,1,receive,262794895366,2825728
262797721746,12,2,receive,262794920545,2801201
262797837664,958,1,receive,262794999239,2838425
262797838334,964,1,receive,262795001085,2837249
262797838989,954,1,receive,262795002131,2836858
262797839655,948,1,receive,262795005276,2834379
262797840332,950,1,receive,262795006730,2833602
262797978082,944,1,receive,262795008940,2969142
262797978767,952,1,receive,262795010977,2967790
262797979465,358,2,receive,262795011078,2968387
262797980162,942,1,receive,262795012579,2967583
262797980830,20,2,receive,262794917166,3063664
262797981502,946,1,receive,262795013041,2968461
262798115309,404,1,receive,262795004819,3110490
262798115986,960,1,receive,262795017037,3098949
262798116955,162,2,receive,262795004120,3112835
262798117632,586,2,receive,262795027329,3090303
262798118325,98,2,receive,262794964568,3153757
262798244531,940,1,receive,262795036121,3208410
262798245214,210,2,receive,262794982172,3263042
262798245880,78,2,receive,262795022226,3223654
262798246544,830,2,receive,262794976027,3270517
262798247217,422,2,receive,262794986217,3261000
262798247904,132,2,receive,262794906265,3341639
262798376885,160,2,receive,262795016847,3360038
262798377565,918,2,receive,262795049131,3328434
262798378255,794,2,receive,262795023196,3355059
262798378941,112,2,receive,262795056133,3322808
262798379626,976,1,receive,262795073341,3306285
262798506418,932,1,receive,262795063596,3442822
262798507085,364,2,receive,262795067571,3439514
262798507742,982,1,receive,262795079056,3428686
262798508432,984,1,receive,262795081846,3426586
262798509132,276,2,receive,262795039009,3470123
262798509824,520,2,receive,262795005006,3504818
262798645533,532,2,receive,262794950393,3695140
262798646228,858,2,receive,262795060530,3585698
262798646914,50,2,receive,262795070087,3576827
262798658321,534,2,receive,262795001570,3656751
262798658999,366,2,receive,262795001827,3657172
262798753082,902,2,receive,262795074010,3679072
262798753746,768,2,receive,262795088944,3664802
262798754437,142,2,receive,262795092212,3662225
262798755172,834,2,receive,262795077081,3678091
262798860843,972,1,receive,262795096706,3764137
262798861527,26,2,receive,262795026885,3834642
262798862220,88,2,receive,262795033006,3829214
262798862908,970,1,receive,262795098258,3764650
262798863582,568,2,receive,262795021119,3842463
262798990748,380,2,receive,262795017297,3973451
262798991447,988,1,receive,262795103063,3888384
262798992156,488,2,receive,262794998425,3993731
262798992821,536,2,receive,262795056071,3936750
262798993455,968,1,receive,262795108099,3885356
262799118451,974,1,receive,262795108579,4009872
262799119152,986,1,receive,262795109127,4010025
262799119840,980,1,receive,262795113334,4006506
262799120514,178,2,receive,262795086010,4034504
262799121224,996,1,receive,262795116543,4004681
262799121910,886,2,receive,262795051291,4070619
262799229319,82,2,receive,262795037400,4191919
262799230008,966,1,receive,262795122559,4107449
262799230699,382,1,receive,262795125558,4105141
262799271029,494,2,receive,262795094268,4176761
262799271707,952,2,receive,262795130580,4141127
262799359573,978,1,receive,262795121129,4238444
262799360250,994,1,receive,262795136986,4223264
262799360916,52,2,receive,262795086293,4274623
262799361605,992,1,receive,262795141061,4220544
262799464274,556,2,receive,262795067005,4397269
262799464954,998,1,receive,262795151122,4313832
262799465638,990,1,receive,262795143046,4322592
262799466331,134,2,receive,262795112506,4353825
262799499009,384,2,receive,262795049007,4450002
262799499676,120,2,receive,262795115113,4384563
262799590323,42,2,receive,262794953452,4636871
262799591010,594,2,receive,262795128109,4462901
262799591691,372,2,receive,262795117342,4474349
262799640210,936,1,receive,262795163022,4477188
262799640895,166,2,receive,262795160380,4480515
262799726598,274,2,receive,262795127683,4598915
262799727300,164,2,receive,262795098347,4628953
262799727989,354,3,receive,262795164104,4563885
262799728660,480,2,receive,262795083207,4645453
262799729321,64,2,receive,262795108346,4620975
262799836571,702,2,receive,262795104028,4732543
262799837232,790,2,receive,262795139013,4698219
262799853700,890,2,receive,262795181759,4671941
262799854367,848,2,receive,262795104007,4750360
262799923880,736,3,receive,262795155175,4768705
262799924579,772,2,receive,262795183574,4741005
262799925279,234,2,receive,262794962090,4963189
262799925971,150,2,receive,262795192006,4733965
262799926663,810,2,receive,262795172580,4754083
262800030177,428,2,receive,262795178010,4852167
262800030846,842,2,receive,262795157008,4873838
262800031509,870,2,receive,262795191036,4840473
262800059974,538,2,receive,262795169780,4890194
262800118652,122,2,receive,262795151020,4967632
262800119324,866,2,receive,262795217068,4902256
262800119987,244,2,receive,262795151315,4968672
262800120655,144,1,receive,262795217066,4903589
262800159199,948,2,receive,262795219572,4939627
262800159882,46,2,receive,262795174774,4985108
262800229440,60,2,receive,262795028316,5201124
262800230091,938,2,receive,262795200017,5030074
262800230750,880,2,receive,262795130518,5100232
262800252814,86,2,receive,262795156011,5096803
262800346199,722,2,receive,262795202016,5144183
262800346889,184,2,receive,262795188876,5158013
262800347546,1000,1,receive,262795235958,5111588
262800369022,778,2,receive,262795225615,5143407
262800390341,358,3,receive,262795158156,5232185
262800459151,14,2,receive,262795227167,5231984
262800459845,854,2,receive,262795025945,5433900
262800460523,62,2,receive,262795198065,5262458
262800461190,874,2,receive,262795207780,5253410
262800461849,128,2,receive,262795211230,5250619
262800462505,348,2,receive,262795126019,5336486
262800582727,236,2,receive,262795176062,5406665
262800583427,698,2,receive,262795182874,5400553
262800584122,976,2,receive,262795242365,5341757
262800584807,542,2,receive,262795202559,5382248
262800632380,34,2,receive,262795224006,5408374
262800712504,896,2,receive,262795262010,5450494
262800713218,198,2,receive,262795175713,5537505
262800713869,6,2,receive,262795222621,5491248
262800714540,754,2,receive,262795279349,5435191
262800715209,720,2,receive,262795182834,5532375
262800715861,186,2,receive,262795255131,5460730
