receive_timestamp,source_vehicle,message_id,event_type,send_timestamp,latency_us
249889146121,38,1,receive,249889136921,9200
249889146605,22,1,receive,249889137125,9480
249889147067,34,1,receive,249889138002,9065
249889147531,40,1,receive,249889138600,8931
249889147995,36,1,receive,249889138677,9318
249889152361,62,1,receive,249889139779,12582
249889152840,74,1,receive,249889139943,12897
249889153364,70,1,receive,249889140442,12922
249889153828,80,1,receive,249889140557,13271
249889158596,50,1,receive,249889140929,17667
249889159078,42,1,receive,249889141130,17948
249889161436,84,1,receive,249889141215,20221
249889161910,54,1,receive,249889141515,20395
249889162383,32,1,receive,249889141754,20629
249889162857,66,1,receive,249889141943,20914
249889163349,64,1,receive,249889142028,21321
249889163833,100,1,receive,249889142413,21420
249889175332,76,1,receive,249889142744,32588
249889175819,82,1,receive,249889143326,32493
249889176317,96,1,receive,249889143463,32854
249889176815,58,1,receive,249889148021,28794
249889177312,88,1,receive,249889148136,29176
249889177805,78,1,receive,249889148186,29619
249889185321,72,1,receive,249889148287,37034
249889185833,68,1,receive,249889149974,35859
249889186342,94,1,receive,249889150153,36189
249889186855,46,1,receive,249889150349,36506
249889187369,44,1,receive,249889152335,35034
249889187883,86,1,receive,249889152340,35543
249889188403,92,1,receive,249889152776,35627
249889191794,90,1,receive,249889155402,36392
249889192314,98,1,receive,249889155773,36541
249889192833,60,1,receive,249889159023,33810
249889193353,20,1,receive,249889158256,35097
249889248571,38,2,receive,249889248251,320
249889255909,2,2,receive,249889255678,231
249889268469,96,2,receive,249889267777,692
249889270264,98,2,receive,249889270013,251
249889277148,10,2,receive,249889276875,273
249889307844,4,2,receive,249889307526,318
249889309226,60,2,receive,249889308961,265
249889312414,50,2,receive,249889312149,265
249889329151,16,2,receive,249889328769,382
249889342535,26,2,receive,249889342164,371
249889349999,12,2,receive,249889349638,361
249889358599,74,2,receive,249889358202,397
249889381403,38,3,receive,249889380685,718
249889403199,88,2,receive,249889402406,793
249889404894,28,2,receive,249889403855,1039
249889406012,42,2,receive,249889405377,635
249889427738,94,2,receive,249889426492,1246
249889442920,60,3,receive,249889441335,1585
249889450483,26,3,receive,249889448607,1876
249889454182,16,3,receive,249889453199,983
249889480531,50,3,receive,249889480190,341
249889492701,24,2,receive,249889490744,1957
249889533970,68,2,receive,249889533231,739
249889537735,96,3,receive,249889535876,1859
249889538743,62,2,receive,249889537801,942
249889552448,76,2,receive,249889550122,2326
249889567690,2,3,receive,249889565781,1909
249889617731,90,2,receive,249889616717,1014
249889627212,98,3,receive,249889626086,1126
249889666126,44,2,receive,249889665448,678
249889668569,2,4,receive,249889667742,827
249889674886,34,2,receive,249889674233,653
249889688487,84,2,receive,249889686752,1735
249889693333,92,2,receive,249889693029,304
249889726692,100,2,receive,249889724809,1883
249889732624,24,3,receive,249889731929,695
249889760264,20,2,receive,249889758424,1840
249889788188,88,3,receive,249889786541,1647
249889789348,80,2,receive,249889788239,1109
249889813597,18,2,receive,249889810746,2851
249889813985,94,3,receive,249889811670,2315
249889814354,52,2,receive,249889812251,2103
249889821771,70,2,receive,249889819919,1852
249889866060,66,2,receive,249889863705,2355
249889866475,86,2,receive,249889864591,1884
249889873202,34,3,receive,249889871138,2064
249889885623,46,2,receive,249889884575,1048
249889886997,72,2,receive,249889885974,1023
249889900718,48,2,receive,249889899611,1107
249889910117,36,2,receive,249889907895,2222
249889924506,14,2,receive,249889923883,623
249889926461,82,2,receive,249889925616,845
249889928605,54,2,receive,249889927353,1252
249889936611,32,2,receive,249889934998,1613
249889943291,4,3,receive,249889941392,1899
249889951234,78,2,receive,249889950968,266
249889954385,12,3,receive,249889953601,784
249889969832,6,2,receive,249889968528,1304
249889979632,58,2,receive,249889978300,1332
249889981691,66,3,receive,249889981007,684
249890000301,46,3,receive,249889998389,1912
249890004954,34,4,receive,249890004719,235
249890028036,56,2,receive,249890026541,1495
249890045289,50,4,receive,249890045028,261
249890050967,64,2,receive,249890049265,1702
249890051937,44,3,receive,249890051547,390
249890059218,8,2,receive,249890057644,1574
249890066353,60,4,receive,249890066075,278
249890066922,22,2,receive,249890066329,593
249890072753,92,3,receive,249890069948,2805
249890080914,62,3,receive,249890080023,891
249890103935,30,2,receive,249890103023,912
249890109370,40,2,receive,249890107019,2351
249890129555,42,3,receive,249890127751,1804
249890130763,56,3,receive,249890129493,1270
249890134298,84,3,receive,249890131859,2439
249890147317,10,3,receive,249890146966,351
249890168892,68,3,receive,249890166846,2046
249890185405,74,3,receive,249890184094,1311
249890201508,24,4,receive,249890200107,1401
249890208796,98,4,receive,249890207436,1360
249890211478,80,3,receive,249890209321,2157
249890216029,54,3,receive,249890214783,1246
249890220180,26,4,receive,249890218900,1280
249890269661,38,4,receive,249890269383,278
249890273075,14,3,receive,249890270750,2325
249890274336,36,3,receive,249890273108,1228
249890281259,12,4,receive,249890279416,1843
249890284836,16,4,receive,249890284091,745
249890325977,42,4,receive,249890324691,1286
249890338786,46,4,receive,249890336644,2142
249890351530,52,3,receive,249890350771,759
249890360507,74,4,receive,249890359166,1341
249890363344,94,4,receive,249890361752,1592
249890375318,14,4,receive,249890374661,657
249890384086,76,3,receive,249890382260,1826
249890394331,40,3,receive,249890393014,1317
249890402984,28,3,receive,249890400899,2085
249890422666,32,3,receive,249890422355,311
249890427789,62,4,receive,249890424730,3059
249890429076,96,4,receive,249890426923,2153
249890444141,86,3,receive,249890442892,1249
249890445809,2,5,receive,249890444819,990
249890456827,54,4,receive,249890454985,1842
249890463389,78,3,receive,249890462307,1082
249890471760,88,4,receive,249890470786,974
249890475867,84,4,receive,249890474069,1798
249890477071,58,3,receive,249890476337,734
249890480741,14,5,receive,249890479038,1703
249890483560,8,3,receive,249890481332,2228
249890492714,18,3,receive,249890492418,296
249890504745,48,3,receive,249890502863,1882
249890507025,50,5,receive,249890506769,256
249890509673,68,4,receive,249890506871,2802
249890528641,10,4,receive,249890527122,1519
249890551525,92,4,receive,249890550437,1088
249890570247,42,5,receive,249890569973,274
249890581882,36,4,receive,249890579987,1895
249890593484,90,3,receive,249890590962,2522
249890595812,96,5,receive,249890595546,266
249890607474,62,5,receive,249890604934,2540
249890634996,28,4,receive,249890634331,665
249890637671,40,4,receive,249890636104,1567
249890651140,98,5,receive,249890649692,1448
249890651539,20,3,receive,249890650958,581
249890664914,100,3,receive,249890663149,1765
249890708587,66,4,receive,249890707879,708
249890717989,8,4,receive,249890716469,1520
249890739029,22,3,receive,249890737822,1207
249890741343,4,4,receive,249890740605,738
249890746407,80,4,receive,249890744697,1710
249890753943,18,4,receive,249890753193,750
249890756864,54,5,receive,249890756132,732
249890787142,46,5,receive,249890786342,800
249890793085,94,5,receive,249890791802,1283
249890810681,6,3,receive,249890808849,1832
249890815316,70,3,receive,249890814117,1199
249890821172,72,3,receive,249890820897,275
249890833710,20,4,receive,249890832417,1293
249890834272,66,5,receive,249890833915,357
249890838928,86,4,receive,249890837093,1835
249890840643,38,5,receive,249890840458,185
249890853586,34,5,receive,249890853370,216
249890857261,14,6,receive,249890854649,2612
249890860862,62,6,receive,249890860015,847
249890863012,82,3,receive,249890861463,1549
249890866341,64,3,receive,249890864087,2254
249890912425,8,5,receive,249890910389,2036
249890971529,96,6,receive,249890970752,777
249890975240,44,4,receive,249890971921,3319
249890987495,68,5,receive,249890986279,1216
249890990353,36,5,receive,249890989286,1067
249891000932,84,5,receive,249890998966,1966
249891014599,70,4,receive,249891013536,1063
249891024611,56,4,receive,249891023302,1309
249891025382,30,3,receive,249891024506,876
249891032887,34,6,receive,249891030650,2237
249891044229,60,5,receive,249891043934,295
249891047241,98,6,receive,249891045303,1938
249891074180,26,5,receive,249891072899,1281
249891080200,6,4,receive,249891078959,1241
249891086451,54,6,receive,249891084824,1627
249891094621,2,6,receive,249891092956,1665
249891100968,38,6,receive,249891100348,620
249891109786,80,5,receive,249891107545,2241
249891110344,52,4,receive,249891108525,1819
249891131653,12,5,receive,249891129378,2275
249891147434,50,6,receive,249891146259,1175
249891150711,76,4,receive,249891149737,974
249891156595,24,5,receive,249891155511,1084
249891164301,88,5,receive,249891163591,710
249891183811,14,7,receive,249891182185,1626
249891210412,16,5,receive,249891209656,756
249891229391,92,5,receive,249891227133,2258
249891238386,10,5,receive,249891237034,1352
249891240624,82,4,receive,249891239122,1502
249891252820,84,6,receive,249891250798,2022
249891273675,48,4,receive,249891272580,1095
249891293545,90,4,receive,249891291665,1880
249891293892,58,4,receive,249891293513,379
249891309063,86,5,receive,249891306784,2279
249891347894,2,7,receive,249891346688,1206
249891360134,70,5,receive,249891359459,675
249891363262,74,5,receive,249891359623,3639
249891369301,20,5,receive,249891368940,361
249891372044,78,4,receive,249891371585,459
249891383432,66,6,receive,249891381314,2118
249891392189,100,4,receive,249891390736,1453
249891399767,32,4,receive,249891398289,1478
249891413343,68,6,receive,249891412590,753
249891434094,52,5,receive,249891431949,2145
249891436481,4,5,receive,249891435509,972
249891440768,22,4,receive,249891438604,2164
249891447809,18,5,receive,249891447198,611
249891450212,26,6,receive,249891449318,894
249891453018,8,6,receive,249891451452,1566
249891460036,42,6,receive,249891458284,1752
249891468376,40,5,receive,249891467655,721
249891479505,72,4,receive,249891477844,1661
249891493741,64,4,receive,249891492119,1622
249891505953,6,5,receive,249891505281,672
249891514420,56,5,receive,249891513230,1190
249891518825,28,5,receive,249891516181,2644
249891519308,94,6,receive,249891517342,1966
249891524888,12,6,receive,249891523729,1159
249891538124,52,6,receive,249891537891,233
249891556333,58,5,receive,249891554592,1741
249891563997,24,6,receive,249891562917,1080
249891572419,16,6,receive,249891571090,1329
249891587013,22,5,receive,249891586369,644
249891604336,44,5,receive,249891602153,2183
249891654241,46,6,receive,249891653505,736
249891671743,14,8,receive,249891670246,1497
249891685792,100,5,receive,249891685551,241
249891728382,54,7,receive,249891726631,1751
249891756197,62,7,receive,249891754462,1735
249891784437,88,6,receive,249891783896,541
249891789096,56,6,receive,249891787187,1909
249891795480,4,6,receive,249891793803,1677
249891802576,70,6,receive,249891800385,2191
249891803087,78,5,receive,249891802435,652
249891809492,40,6,receive,249891803532,5960
249891809984,64,5,receive,249891806584,3400
249891810490,50,7,receive,249891806796,3694
249891825057,38,7,receive,249891823166,1891
249891830539,96,7,receive,249891829868,671
249891832112,34,7,receive,249891831930,182
249891845168,8,7,receive,249891844920,248
249891847232,84,7,receive,249891847018,214
249891849066,28,6,receive,249891847058,2008
249891886273,36,6,receive,249891885182,1091
249891894528,26,7,receive,249891893113,1415
249891936123,60,6,receive,249891934362,1761
249891948658,98,7,receive,249891946951,1707
249891949990,54,8,receive,249891948695,1295
249891959377,74,6,receive,249891957688,1689
249891964339,30,4,receive,249891961959,2380
249891998966,10,6,receive,249891997524,1442
249892001411,48,5,receive,249892000491,920
249892013951,20,6,receive,249892013006,945
249892044969,6,6,receive,249892043157,1812
249892046209,18,6,receive,249892045506,703
249892059940,82,5,receive,249892058761,1179
249892065100,70,7,receive,249892062932,2168
249892065475,12,7,receive,249892063728,1747
249892067200,80,6,receive,249892066235,965
249892078954,92,6,receive,249892078750,204
249892092143,14,9,receive,249892091917,226
249892110291,58,6,receive,249892105671,4620
249892110791,76,5,receive,249892106846,3945
249892111301,56,7,receive,249892108459,2842
249892130906,46,7,receive,249892130103,803
249892156996,32,5,receive,249892153709,3287
249892157375,86,6,receive,249892153733,3642
249892159432,60,7,receive,249892159110,322
249892164773,66,7,receive,249892161009,3764
249892165121,94,7,receive,249892161185,3936
249892182476,2,8,receive,249892181064,1412
249892186069,4,7,receive,249892184364,1705
249892189236,30,5,receive,249892187885,1351
249892208637,42,7,receive,249892207329,1308
249892213821,52,7,receive,249892212631,1190
249892222447,88,7,receive,249892222214,233
249892229818,12,8,receive,249892229102,716
249892242736,90,5,receive,249892241473,1263
249892256823,44,6,receive,249892255978,845
249892285017,68,7,receive,249892283354,1663
249892287771,38,8,receive,249892286609,1162
249892307034,8,8,receive,249892304763,2271
249892333834,78,6,receive,249892332388,1446
249892351530,86,7,receive,249892351273,257
249892357924,76,6,receive,249892356276,1648
249892372368,24,7,receive,249892371164,1204
249892376242,50,8,receive,249892375093,1149
249892379714,44,7,receive,249892379565,149
249892388228,34,8,receive,249892384962,3266
249892388710,28,7,receive,249892386177,2533
249892412848,100,6,receive,249892412483,365
249892432268,6,7,receive,249892430463,1805
249892436266,72,5,receive,249892434485,1781
249892455452,70,8,receive,249892453176,2276
249892456892,66,8,receive,249892454196,2696
249892458902,74,7,receive,249892457038,1864
249892461250,16,7,receive,249892460009,1241
249892507246,42,8,receive,249892506467,779
249892523990,32,6,receive,249892522758,1232
249892536488,96,8,receive,249892535653,835
249892560252,46,8,receive,249892559982,270
249892568302,22,6,receive,249892565613,2689
249892568771,88,8,receive,249892566729,2042
249892571507,4,8,receive,249892569199,2308
249892587319,74,8,receive,249892586688,631
249892599361,54,9,receive,249892597881,1480
249892600423,30,6,receive,249892599914,509
249892614698,48,6,receive,249892612918,1780
249892628016,62,8,receive,249892627249,767
249892631582,14,10,receive,249892630127,1455
249892637124,40,7,receive,249892636085,1039
249892639769,98,8,receive,249892638316,1453
249892652604,84,8,receive,249892651502,1102
249892655254,60,8,receive,249892653144,2110
249892667380,34,9,receive,249892667185,195
249892678361,36,7,receive,249892677027,1334
249892701909,38,9,receive,249892699828,2081
249892704418,6,8,receive,249892703939,479
249892720433,64,6,receive,249892719748,685
249892747283,80,7,receive,249892745719,1564
249892760709,58,7,receive,249892759293,1416
249892768514,86,8,receive,249892766945,1569
249892773208,42,9,receive,249892771372,1836
249892804056,82,6,receive,249892803102,954
249892806230,44,8,receive,249892803821,2409
249892808135,52,8,receive,249892807135,1000
249892818250,18,7,receive,249892817972,278
249892826400,62,9,receive,249892826195,205
249892834915,94,8,receive,249892834699,216
249892867197,16,8,receive,249892866882,315
249892872401,86,9,receive,249892871664,737
249892888096,26,8,receive,249892886660,1436
249892889203,24,8,receive,249892888598,605
249892893711,20,7,receive,249892892370,1341
249892902755,74,9,receive,249892901329,1426
249892905717,4,9,receive,249892905074,643
249892919268,10,7,receive,249892918962,306
249892928660,90,6,receive,249892928456,204
249892935248,98,9,receive,249892934430,818
249892952628,92,7,receive,249892951968,660
249892961662,100,7,receive,249892960628,1034
249892970209,56,8,receive,249892968799,1410
249892981500,58,8,receive,249892981190,310
249892990814,66,9,receive,249892990545,269
249892999587,2,9,receive,249892998544,1043
249893003544,76,7,receive,249893002861,683
249893020400,46,9,receive,249893018853,1547
249893020755,60,9,receive,249893019497,1258
249893027941,22,7,receive,249893027675,266
249893036260,12,9,receive,249893034771,1489
249893044811,38,10,receive,249893044548,263
249893048547,36,8,receive,249893047859,688
249893061096,90,7,receive,249893059403,1693
249893069762,70,9,receive,249893069433,329
249893075688,18,8,receive,249893075033,655
249893091060,94,9,receive,249893086691,4369
249893109375,8,9,receive,249893109023,352
249893145807,80,8,receive,249893145438,369
249893150791,96,9,receive,249893150486,305
249893172089,78,7,receive,249893170018,2071
249893196272,34,10,receive,249893195889,383
249893202207,14,11,receive,249893201873,334
249893204112,50,9,receive,249893203840,272
249893211342,92,8,receive,249893211012,330
249893223631,68,8,receive,249893223306,325
249893238074,28,8,receive,249893235025,3049
249893264959,4,10,receive,249893264575,384
249893293406,40,8,receive,249893293016,390
249893305486,42,10,receive,249893305096,390
249893314420,64,7,receive,249893314019,401
249893325070,82,7,receive,249893321225,3845
249893335395,76,8,receive,249893335030,365
249893343368,54,10,receive,249893343036,332
249893360609,52,9,receive,249893360236,373
249893366584,2,10,receive,249893366258,326
249893369217,22,8,receive,249893368465,752
249893371905,88,9,receive,249893370363,1542
249893372397,36,9,receive,249893371707,690
249893401088,48,7,receive,249893400737,351
249893407042,30,7,receive,249893406773,269
249893411724,72,6,receive,249893410141,1583
249893430279,84,9,receive,249893428469,1810
249893452280,92,9,receive,249893451576,704
249893454516,28,9,receive,249893453141,1375
249893460067,6,9,receive,249893459744,323
249893478384,98,10,receive,249893476645,1739
249893484992,58,9,receive,249893484025,967
249893489462,60,10,receive,249893487841,1621
249893509648,86,10,receive,249893507458,2190
249893511235,32,7,receive,249893509980,1255
249893518557,26,9,receive,249893516695,1862
249893544647,66,10,receive,249893543420,1227
249893547841,40,9,receive,249893546294,1547
249893556297,70,10,receive,249893554274,2023
249893557398,44,9,receive,249893557134,264
249893562243,78,8,receive,249893560215,2028
249893589342,58,10,receive,249893588507,835
249893606500,24,9,receive,249893604383,2117
249893640887,74,10,receive,249893640508,379
249893649261,12,10,receive,249893646680,2581
249893652206,16,9,receive,249893650289,1917
249893687465,62,10,receive,249893686439,1026
249893694522,40,10,receive,249893693585,937
249893711127,38,11,receive,249893710591,536
249893714571,24,10,receive,249893712802,1769
249893716326,56,9,receive,249893715688,638
249893723827,20,8,receive,249893722297,1530
249893724218,34,11,receive,249893722994,1224
249893734112,46,10,receive,249893733186,926
249893736210,84,10,receive,249893735183,1027
249893740623,4,11,receive,249893740097,526
249893758181,8,10,receive,249893757549,632
249893774845,94,10,receive,249893774025,820
249893786282,76,9,receive,249893785951,331
249893803893,42,11,receive,249893801782,2111
249893805842,50,10,receive,249893803628,2214
249893806887,58,11,receive,249893806653,234
249893812079,100,8,receive,249893811388,691
249893828693,92,10,receive,249893823007,5686
249893832315,6,10,receive,249893832007,308
249893846912,96,10,receive,249893845721,1191
249893859797,18,9,receive,249893859516,281
249893864420,46,11,receive,249893863664,756
249893870965,2,11,receive,249893870176,789
249893876437,12,11,receive,249893875016,1421
249893879700,48,8,receive,249893878329,1371
249893880670,84,11,receive,249893880454,216
249893884644,10,8,receive,249893882558,2086
249893920419,62,11,receive,249893920096,323
249893925195,68,9,receive,249893924514,681
249893927426,76,10,receive,249893927113,313
249893979584,90,8,receive,249893977741,1843
249893982863,82,8,receive,249893982079,784
249894012792,60,11,receive,249894011445,1347
249894017340,6,11,receive,249894016408,932
249894042278,30,8,receive,249894037009,5269
249894042656,52,10,receive,249894041973,683
249894048659,14,12,receive,249894048017,642
249894055064,12,12,receive,249894053898,1166
249894065788,46,12,receive,249894063827,1961
249894073273,64,8,receive,249894072640,633
249894089861,76,11,receive,249894087598,2263
249894099707,26,10,receive,249894097838,1869
249894117393,38,12,receive,249894115482,1911
249894131236,80,9,receive,249894129352,1884
249894132827,98,11,receive,249894131396,1431
