receive_timestamp,source_vehicle,message_id,event_type,send_timestamp,latency_us
373562852,196,4,receive,373313394,249458
373563388,408,2,receive,373314436,248952
373563749,974,2,receive,373314787,248962
373564090,140,2,receive,373316070,248020
373564430,104,4,receive,373316474,247956
373564793,184,4,receive,373316662,248131
373565209,166,1,receive,373316885,248324
373565564,128,4,receive,373317077,248487
373565918,790,1,receive,373318464,247454
373566264,50,1,receive,373318434,247830
373566604,798,1,receive,373318566,248038
374071187,196,5,receive,373318774,752413
374071752,54,1,receive,373318997,752755
374072195,18,2,receive,373320016,752179
374072642,202,3,receive,373294291,778351
374073103,80,1,receive,373322157,750946
374073554,86,3,receive,373322441,751113
374073999,400,1,receive,373323456,750543
374074444,122,1,receive,373296841,777603
374074890,158,1,receive,373304081,770809
374075387,230,2,receive,373326675,748712
374298773,320,2,receive,373327062,971711
374299320,98,3,receive,373323391,975929
374299717,384,2,receive,373330017,969700
374300116,252,1,receive,373331018,969098
374300538,634,2,receive,373331441,969097
374300960,632,1,receive,373332263,968697
374301400,118,1,receive,373332253,969147
374301796,6,4,receive,373278304,1023492
374302614,90,3,receive,373332855,969759
374303125,818,1,receive,373332891,970234
374560421,90,4,receive,373333221,1227200
374560887,400,2,receive,373333307,1227580
374561480,44,5,receive,373273715,1287765
374561950,150,3,receive,373334297,1227653
374562423,154,2,receive,373334689,1227734
374562904,486,2,receive,373334774,1228130
374563366,758,1,receive,373334743,1228623
374563838,182,3,receive,373296292,1267546
374564351,206,2,receive,373335639,1228712
374564817,972,1,receive,373336349,1228468
374821626,798,2,receive,373336605,1485021
374822075,152,4,receive,373321810,1500265
374822610,728,1,receive,373337175,1485435
374823054,58,4,receive,373280331,1542723
374823433,670,1,receive,373337448,1485985
374823812,132,1,receive,373337427,1486385
374824250,766,1,receive,373337608,1486642
374824655,84,3,receive,373324172,1500483
374825054,312,1,receive,373339142,1485912
374825440,312,2,receive,373339616,1485824
374825818,100,1,receive,373257727,1568091
374826274,96,3,receive,373340772,1485502
375133863,188,2,receive,373340656,1793207
375134306,274,1,receive,373342284,1792022
375134925,204,1,receive,373342449,1792476
375135324,426,2,receive,373343822,1791502
375135721,18,3,receive,373343300,1792421
375136113,408,3,receive,373344177,1791936
375136542,338,1,receive,373344313,1792229
375136973,12,5,receive,373315677,1821296
375137384,138,1,receive,373345262,1792122
375137799,626,1,receive,373345494,1792305
375139035,110,3,receive,373345744,1793291
375350607,590,5,receive,373345797,2004810
375351027,782,1,receive,373346124,2004903
375351553,160,3,receive,373346421,2005132
375351988,290,1,receive,373311159,2040829
375352522,964,1,receive,373346825,2005697
375352922,96,4,receive,373346856,2006066
375353344,432,2,receive,373347684,2005660
375353801,670,2,receive,373349026,2004775
375354210,632,2,receive,373350024,2004186
375354589,106,3,receive,373351343,2003246
375354965,708,1,receive,373351772,2003193
375584652,158,2,receive,373351916,2232736
375585078,150,4,receive,373352784,2232294
375585672,284,1,receive,373353815,2231857
375586127,70,5,receive,373288342,2297785
375586540,868,2,receive,373354805,2231735
375587009,426,3,receive,373354781,2232228
375587450,730,1,receive,373355393,2232057
375587861,206,3,receive,373355353,2232508
375588252,1000,1,receive,373355649,2232603
375588728,382,1,receive,373356097,2232631
375589242,320,3,receive,373357048,2232194
375843473,80,2,receive,373357455,2486018
375843918,36,2,receive,373357977,2485941
375844522,56,3,receive,373241375,2603147
375844919,490,1,receive,373358269,2486650
375845313,400,3,receive,373358854,2486459
375845853,554,1,receive,373359320,2486533
375846266,598,1,receive,373359649,2486617
375846666,104,5,receive,373360476,2486190
375847063,212,1,receive,373360429,2486634
375847484,818,2,receive,373360893,2486591
375847900,128,5,receive,373361359,2486541
376104308,190,1,receive,373362713,2741595
376104805,764,1,receive,373362713,2742092
376105402,210,2,receive,373363083,2742319
376105861,230,3,receive,373364522,2741339
376106289,778,4,receive,373364429,2741860
376106710,592,1,receive,373364608,2742102
376107184,488,1,receive,373367149,2740035
376107629,426,4,receive,373367583,2740046
376108049,332,1,receive,373367726,2740323
376108462,354,1,receive,373368455,2740007
376108868,582,1,receive,373368957,2739911
376365954,114,5,receive,373368894,2997060
376366405,86,4,receive,373369044,2997361
376366938,640,1,receive,373369448,2997490
376367331,166,2,receive,373358761,3008570
376367766,300,1,receive,373370044,2997722
376368183,192,1,receive,373370182,2998001
376368587,712,1,receive,373370313,2998274
376368990,486,3,receive,373371338,2997652
376369430,130,3,receive,373309045,3060385
376369902,524,1,receive,373374149,2995753
376370333,130,4,receive,373373933,2996400
376602847,530,1,receive,373374600,3228247
376603303,436,1,receive,373374829,3228474
376603830,130,5,receive,373375029,3228801
376604316,636,2,receive,373376013,3228303
376604725,90,5,receive,373376866,3227859
376605124,508,1,receive,373376887,3228237
376605521,972,2,receive,373377276,3228245
376605947,130,6,receive,373376476,3229471
376606359,426,5,receive,373377644,3228715
376606756,634,3,receive,373378345,3228411
376607246,918,1,receive,373378463,3228783
376850946,618,1,receive,373379066,3471880
376851406,166,3,receive,373380013,3471393
376852045,112,2,receive,373285041,3567004
376852489,8,5,receive,373278178,3574311
376853346,196,6,receive,373381922,3471424
376853878,868,3,receive,373382063,3471815
376854286,90,6,receive,373382316,3471970
376854795,400,4,receive,373382781,3472014
376855205,432,3,receive,373383008,3472197
376855706,340,1,receive,373296934,3558772
377100850,486,4,receive,373383975,3716875
377101285,126,2,receive,373305048,3796237
377101801,222,1,receive,373375932,3725869
377102189,316,1,receive,373386209,3715980
377102575,486,5,receive,373386787,3715788
377102983,730,2,receive,373387278,3715705
377103395,2,5,receive,373273391,3830004
377103766,154,3,receive,373388709,3715057
377104143,734,1,receive,373389539,3714604
377104516,444,1,receive,373334200,3770316
377104909,436,2,receive,373390018,3714891
377105319,638,1,receive,373371725,3733594
377342891,492,2,receive,373390020,3952871
377343299,366,1,receive,373390145,3953154
377343868,618,2,receive,373390437,3953431
377344264,62,4,receive,373250337,4093927
377344653,774,1,receive,373390624,3954029
377345057,756,1,receive,373390885,3954172
377345444,554,2,receive,373391272,3954172
377345897,196,7,receive,373391318,3954579
377346287,678,1,receive,373391717,3954570
377346734,964,2,receive,373391772,3954962
377347209,724,1,receive,373392160,3955049
377600141,64,4,receive,373354344,4245797
377600768,488,2,receive,373393759,4207009
377601163,798,3,receive,373393968,4207195
377601590,320,4,receive,373394395,4207195
377601986,222,2,receive,373395466,4206520
377602373,778,5,receive,373395541,4206832
377602761,778,6,receive,373395881,4206880
377603165,32,3,receive,373285087,4318078
377603626,206,4,receive,373396720,4206906
377604013,336,1,receive,373396941,4207072
377604446,2,6,receive,373393761,4210685
377844631,766,2,receive,373397603,4447028
377845021,352,1,receive,373355333,4489688
377845522,164,2,receive,373287511,4558011
377845898,434,1,receive,373398867,4447031
377846363,804,1,receive,373398932,4447431
377846923,456,2,receive,373399942,4446981
377847413,612,2,receive,373391742,4455671
377847810,858,1,receive,373343766,4504044
377848266,150,5,receive,373400589,4447677
377848660,560,1,receive,373401198,4447462
377849046,330,1,receive,373400981,4448065
378071947,204,2,receive,373401651,4670296
378072343,564,1,receive,373401672,4670671
378072845,222,3,receive,373402437,4670408
378073222,778,7,receive,373402673,4670549
378073706,230,4,receive,373403215,4670491
378074093,586,1,receive,373403229,4670864
378074476,670,3,receive,373403888,4670588
378074858,982,1,receive,373404064,4670794
378075272,592,2,receive,373404299,4670973
378075669,554,3,receive,373404704,4670965
378076055,994,1,receive,373404655,4671400
378319060,634,4,receive,373405133,4913927
378319508,634,5,receive,373405599,4913909
378320078,426,6,receive,373405950,4914128
378320460,964,3,receive,373407361,4913099
378320837,316,2,receive,373407547,4913290
378321266,844,1,receive,373407892,4913374
378321664,586,2,receive,373408806,4912858
378322052,566,1,receive,373360373,4961679
378322446,482,1,receive,373410119,4912327
378322835,370,1,receive,373410438,4912397
378323265,836,1,receive,373411253,4912012
378512589,836,2,receive,373411872,5100717
378513038,54,2,receive,373411868,5101170
378513593,150,6,receive,373412059,5101534
378514060,252,2,receive,373415349,5098711
378514504,312,3,receive,373415998,5098506
378514948,448,2,receive,373327134,5187814
378515411,312,4,receive,373416340,5099071
378515871,238,1,receive,373416159,5099712
378516345,396,1,receive,373416732,5099613
378516775,868,4,receive,373416750,5100025
378517236,640,2,receive,373417199,5100037
378722458,318,1,receive,373417412,5305046
378722911,530,2,receive,373420076,5302835
378723477,746,1,receive,373420030,5303447
378723922,192,2,receive,373420126,5303796
378724369,810,1,receive,373420516,5303853
378724825,502,1,receive,373422960,5301865
378725295,888,1,receive,373423157,5302138
378725741,892,1,receive,373424788,5300953
378726185,896,1,receive,373425194,5300991
378726665,244,1,receive,373425208,5301457
378930667,924,1,receive,373425571,5505096
378931143,82,3,receive,373387972,5543171
378931719,964,4,receive,373427070,5504649
378932199,300,2,receive,373427165,5505034
378932656,492,3,receive,373427954,5504702
378933132,166,4,receive,373430014,5503118
378933609,332,2,receive,373417168,5516441
378934073,428,1,receive,373430101,5503972
378934565,792,1,receive,373430663,5503902
378935023,450,1,receive,373431662,5503361
379137926,582,2,receive,373432544,5705382
379138407,506,1,receive,373432861,5705546
379138958,538,1,receive,373433495,5705463
379139441,478,1,receive,373433985,5705456
379139905,230,5,receive,373434750,5705155
379140371,498,1,receive,373436296,5704075
379140829,964,5,receive,373438204,5702625
379141316,166,5,receive,373438419,5702897
379141857,300,3,receive,373438927,5702930
379314866,224,1,receive,373439255,5875611
379315388,124,1,receive,373430406,5884982
