receive_timestamp,source_vehicle,message_id,event_type,send_timestamp,latency_us
262794828996,846,1,receive,262794808433,20563
262794829462,700,1,receive,262794808661,20801
262794829850,666,1,receive,262794808832,21018
262794830236,726,1,receive,262794809152,21084
262794872402,886,1,receive,262794809654,62748
262794872780,280,1,receive,262794804038,68742
262794873196,534,1,receive,262794810019,63177
262794873587,742,1,receive,262794810046,63541
262794873975,734,1,receive,262794805975,68000
262794959416,738,1,receive,262794804564,154852
262794959808,578,1,receive,262794813571,146237
262794960231,614,1,receive,262794818064,142167
262794960643,766,1,receive,262794818592,142051
262794961060,814,1,receive,262794819547,141513
262794995293,760,1,receive,262794820818,174475
262794995706,620,1,receive,262794817830,177876
262795048850,864,1,receive,262794816273,232577
262795049300,612,1,receive,262794824582,224718
262795049728,768,1,receive,262794826059,223669
262795053998,472,1,receive,262794824203,229795
262795057385,890,1,receive,262794828041,229344
262795057809,878,1,receive,262794829373,228436
262795088459,558,1,receive,262794826751,261708
262795135280,882,1,receive,262794827769,307511
262795135727,730,1,receive,262794831114,304613
262795136185,780,1,receive,262794831798,304387
262795136626,32,1,receive,262794664030,472596
262795137116,174,1,receive,262794707028,430088
262795137566,538,1,receive,262794831395,306171
262795186491,774,1,receive,262794834551,351940
262795186936,782,1,receive,262794831156,355780
262795235807,636,1,receive,262794835757,400050
262795236275,230,1,receive,262794836017,400258
262795236717,568,1,receive,262794828903,407814
262795237173,276,1,receive,262794718788,518385
262795237618,184,1,receive,262794837518,400100
262795238067,888,1,receive,262794838015,400052
262795238517,708,1,receive,262794823509,415008
262795238966,704,1,receive,262794836511,402455
262795353356,536,1,receive,262794827439,525917
262795353829,884,1,receive,262794818675,535154
262795354302,880,1,receive,262794828803,525499
262795354758,856,1,receive,262794841630,513128
262795355226,674,1,receive,262794842731,512495
262795355684,678,1,receive,262794849031,506653
262795465431,868,1,receive,262794833809,631622
262795465879,698,1,receive,262794848604,617275
262795466359,806,1,receive,262794853081,613278
262795466827,778,1,receive,262794855512,611315
262795467320,720,1,receive,262794843242,624078
262795467780,844,1,receive,262794842017,625763
262795468247,900,1,receive,262794839300,628947
262795468708,464,1,receive,262794827781,640927
262795572816,804,1,receive,262794860983,711833
262795573304,444,1,receive,262794861645,711659
262795573780,790,1,receive,262794850137,723643
262795574276,896,1,receive,262794858653,715623
262795574746,870,1,receive,262794831029,743717
262795575226,912,1,receive,262794858038,717188
262795575690,116,1,receive,262794852130,723560
262795685200,716,1,receive,262794853883,831317
262795685666,876,1,receive,262794852260,833406
262795686145,732,1,receive,262794852037,834108
262795686615,854,1,receive,262794864460,822155
262795687098,914,1,receive,262794874858,812240
262795687564,828,1,receive,262794871988,815576
262795688039,910,1,receive,262794873486,814553
262795688517,892,1,receive,262794863422,825095
262795688984,600,1,receive,262794874615,814369
262795800494,124,2,receive,262794780600,1019894
262795800975,924,1,receive,262794879157,921818
262795801463,918,1,receive,262794884191,917272
262795801920,858,1,receive,262794875062,926858
262795802399,628,2,receive,262794887482,914917
262795802861,222,1,receive,262794858074,944787
262795904269,826,1,receive,262794888886,1015383
262795904717,908,1,receive,262794887953,1016764
262795905169,916,1,receive,262794895909,1009260
262795905628,898,1,receive,262794897612,1008016
262795906095,206,1,receive,262794894084,1012011
262795906562,906,1,receive,262794896323,1010239
262796006936,176,1,receive,262794885163,1121773
262796007424,850,1,receive,262794880639,1126785
262796007874,702,1,receive,262794859037,1148837
262796008549,920,1,receive,262794906037,1102512
262796009004,904,1,receive,262794898967,1110037
262796009466,104,1,receive,262794693040,1316426
262796009922,894,1,receive,262794910035,1099887
262796010410,714,1,receive,262794869932,1140478
262796010882,432,2,receive,262794897567,1113315
262796139705,362,1,receive,262794890412,1249293
262796140203,74,2,receive,262794891949,1248254
262796140683,138,1,receive,262794906230,1234453
262796141164,872,1,receive,262794868647,1272517
262796141641,926,1,receive,262794922243,1219398
262796142124,860,1,receive,262794864783,1277341
262796254116,928,1,receive,262794926348,1327768
262796254582,922,1,receive,262794927383,1327199
262796255047,442,2,receive,262794921009,1334038
262796255504,172,1,receive,262794871811,1383693
262796255959,152,1,receive,262794921274,1334685
262796256488,820,2,receive,262794926445,1330043
262796256936,562,1,receive,262794948009,1308927
262796384522,378,1,receive,262794945663,1438859
262796384999,114,1,receive,262794899455,1485544
262796385490,758,2,receive,262794953280,1432210
262796385957,110,2,receive,262794921860,1464097
262796386431,148,1,receive,262794843310,1543121
262796386892,772,1,receive,262794960625,1426267
262796387362,212,2,receive,262794923249,1464113
262796387824,354,2,receive,262794884812,1503012
262796488316,938,1,receive,262794965518,1522798
262796488762,736,2,receive,262794901012,1587750
262796489228,934,1,receive,262794966837,1522391
262796489670,580,2,receive,262794955918,1533752
262796490127,888,2,receive,262794981489,1508638
262796490576,956,1,receive,262794984049,1506527
262796491022,508,2,receive,262794961472,1529550
262796491470,262,2,receive,262794986507,1504963
262796491920,962,1,receive,262794987230,1504690
262796597612,220,1,receive,262794979264,1618348
262796598069,838,2,receive,262794990251,1607818
262796598513,930,1,receive,262794990426,1608087
262796598948,700,2,receive,262794990760,1608188
262796599390,418,1,receive,262794895366,1704024
262796599847,12,2,receive,262794920545,1679302
262796600316,958,1,receive,262794999239,1601077
262796600774,964,1,receive,262795001085,1599689
262796725795,954,1,receive,262795002131,1723664
262796726281,948,1,receive,262795005276,1721005
262796726736,950,1,receive,262795006730,1720006
262796727207,944,1,receive,262795008940,1718267
262796727660,952,1,receive,262795010977,1716683
262796728125,358,2,receive,262795011078,1717047
262796728589,942,1,receive,262795012579,1716010
262796827927,20,2,receive,262794917166,1910761
262796828396,946,1,receive,262795013041,1815355
262796828842,404,1,receive,262795004819,1824023
262796829314,960,1,receive,262795017037,1812277
262796829784,162,2,receive,262795004120,1825664
262796853028,586,2,receive,262795027329,1825699
262796866390,98,2,receive,262794964568,1901822
262796926041,940,1,receive,262795036121,1889920
262796926498,210,2,receive,262794982172,1944326
262796926950,78,2,receive,262795022226,1904724
262796927417,830,2,receive,262794976027,1951390
262796935056,422,2,receive,262794986217,1948839
262796935520,132,2,receive,262794906265,2029255
262796935977,160,2,receive,262795016847,1919130
262796936453,918,2,receive,262795049131,1887322
262796936910,794,2,receive,262795023196,1913714
262797038626,112,2,receive,262795056133,1982493
262797039084,976,1,receive,262795073341,1965743
262797039539,932,1,receive,262795063596,1975943
262797039987,364,2,receive,262795067571,1972416
262797073115,982,1,receive,262795079056,1994059
262797079611,984,1,receive,262795081846,1997765
262797157025,276,2,receive,262795039009,2118016
262797157508,520,2,receive,262795005006,2152502
262797157971,532,2,receive,262794950393,2207578
262797158455,858,2,receive,262795060530,2097925
262797158918,50,2,receive,262795070087,2088831
262797159388,534,2,receive,262795001570,2157818
262797159846,366,2,receive,262795001827,2158019
262797259328,768,2,receive,262795088944,2170384
262797259792,142,2,receive,262795092212,2167580
262797260284,834,2,receive,262795077081,2183203
262797260755,972,1,receive,262795096706,2164049
262797261232,26,2,receive,262795026885,2234347
262797261698,88,2,receive,262795033006,2228692
262797262182,970,1,receive,262795098258,2163924
262797262654,568,2,receive,262795021119,2241535
262797382796,380,2,receive,262795017297,2365499
262797383309,988,1,receive,262795103063,2280246
262797383788,488,2,receive,262794998425,2385363
262797384271,536,2,receive,262795056071,2328200
262797384744,968,1,receive,262795108099,2276645
262797385229,974,1,receive,262795108579,2276650
262797385706,986,1,receive,262795109127,2276579
262797518232,980,1,receive,262795113334,2404898
262797518696,178,2,receive,262795086010,2432686
262797519174,996,1,receive,262795116543,2402631
262797519649,886,2,receive,262795051291,2468358
262797520120,82,2,receive,262795037400,2482720
262797520593,966,1,receive,262795122559,2398034
262797521075,382,1,receive,262795125558,2395517
262797521544,494,2,receive,262795094268,2427276
262797650588,952,2,receive,262795130580,2520008
262797651084,978,1,receive,262795121129,2529955
262797651563,994,1,receive,262795136986,2514577
262797652059,52,2,receive,262795086293,2565766
262797652531,992,1,receive,262795141061,2511470
262797681169,556,2,receive,262795067005,2614164
262797681617,998,1,receive,262795151122,2530495
262797768569,990,1,receive,262795143046,2625523
262797769042,134,2,receive,262795112506,2656536
262797769497,384,2,receive,262795049007,2720490
262797769964,120,2,receive,262795115113,2654851
262797770429,42,2,receive,262794953452,2816977
262797770884,594,2,receive,262795128109,2642775
262797771350,372,2,receive,262795117342,2654008
262797771802,936,1,receive,262795163022,2608780
262797890271,166,2,receive,262795160380,2729891
262797890713,274,2,receive,262795127683,2763030
262797891194,164,2,receive,262795098347,2792847
262797891661,354,3,receive,262795164104,2727557
262797902513,480,2,receive,262795083207,2819306
262797902975,64,2,receive,262795108346,2794629
262797903433,702,2,receive,262795104028,2799405
262797903897,790,2,receive,262795139013,2764884
262798004332,890,2,receive,262795181759,2822573
262798004789,848,2,receive,262795104007,2900782
262798005258,736,3,receive,262795155175,2850083
262798005720,772,2,receive,262795183574,2822146
262798006160,234,2,receive,262794962090,3044070
262798006590,150,2,receive,262795192006,2814584
262798096394,810,2,receive,262795172580,2923814
262798096841,428,2,receive,262795178010,2918831
262798097287,842,2,receive,262795157008,2940279
262798097715,870,2,receive,262795191036,2906679
262798098177,538,2,receive,262795169780,2928397
262798098631,122,2,receive,262795151020,2947611
262798099090,866,2,receive,262795217068,2882022
262798099543,244,2,receive,262795151315,2948228
262798228521,144,1,receive,262795217066,3011455
262798228991,948,2,receive,262795219572,3009419
262798229468,46,2,receive,262795174774,3054694
262798229923,60,2,receive,262795028316,3201607
262798230385,938,2,receive,262795200017,3030368
262798230833,880,2,receive,262795130518,3100315
262798231292,86,2,receive,262795156011,3075281
262798231742,722,2,receive,262795202016,3029726
262798344843,184,2,receive,262795188876,3155967
262798345342,1000,1,receive,262795235958,3109384
262798345814,778,2,receive,262795225615,3120199
262798346300,358,3,receive,262795158156,3188144
262798363196,14,2,receive,262795227167,3136029
262798363641,854,2,receive,262795025945,3337696
262798364094,62,2,receive,262795198065,3166029
262798444690,874,2,receive,262795207780,3236910
262798445168,128,2,receive,262795211230,3233938
262798445626,348,2,receive,262795126019,3319607
262798446090,236,2,receive,262795176062,3270028
262798446555,698,2,receive,262795182874,3263681
262798447023,976,2,receive,262795242365,3204658
262798551035,542,2,receive,262795202559,3348476
262798551513,34,2,receive,262795224006,3327507
262798551975,896,2,receive,262795262010,3289965
262798552448,198,2,receive,262795175713,3376735
262798552906,6,2,receive,262795222621,3330285
262798553378,754,2,receive,262795279349,3274029
262798553849,720,2,receive,262795182834,3371015
262798554336,186,2,receive,262795255131,3299205
262798554800,682,2,receive,262795174077,3380723
262798678207,76,2,receive,262795242141,3436066
262798678673,954,2,receive,262795186367,3492306
262798679153,80,2,receive,262795265363,3413790
262798679626,168,2,receive,262795223810,3455816
262798693306,586,3,receive,262795298077,3395229
262798693742,840,2,receive,262795288011,3405731
262798694215,262,3,receive,262795303009,3391206
262798694677,958,2,receive,262795271506,3423171
262798800889,618,2,receive,262795192141,3608748
262798801352,590,2,receive,262795291956,3509396
262798801794,508,3,receive,262795299362,3502432
262798802253,670,2,receive,262795315688,3486565
262798802705,940,2,receive,262795298578,3504127
262798803154,580,3,receive,262795239149,3564005
262798803590,442,3,receive,262795317101,3486489
262798912052,222,2,receive,262795262006,3650046
262798912478,116,2,receive,262795283474,3629004
262798912893,704,2,receive,262795281568,3631325
262798913344,202,2,receive,262795211565,3701779
262798913792,230,2,receive,262795316860,3596932
262798914240,88,3,receive,262795262006,3652234
262798914672,54,2,receive,262795312072,3602600
262798915117,24,2,receive,262795265106,3650011
262798915556,356,2,receive,262795334689,3580867
262798915997,994,2,receive,262795279482,3636515
262799044547,972,2,receive,262795335015,3709532
262799045012,932,2,receive,262795362451,3682561
262799045479,716,2,receive,262795286512,3758967
262799045937,978,2,receive,262795291139,3754798
262799046406,480,3,receive,262795365448,3680958
262799081372,876,2,receive,262795299282,3782090
262799081822,224,1,receive,262795360803,3721019
262799166480,674,2,receive,262795319006,3847474
262799166921,806,2,receive,262795326007,3840914
262799167447,532,3,receive,262795382857,3784590
262799167868,910,2,receive,262795350269,3817599
262799168351,162,3,receive,262795324648,3843703
262799168789,526,2,receive,262795297210,3871579
262799169239,50,3,receive,262795387475,3781764
262799274351,26,3,receive,262795375402,3898949
262799274813,352,2,receive,262795333283,3941530
262799275291,956,2,receive,262795347798,3927493
262799275761,112,3,receive,262795227563,4048198
262799276226,794,3,receive,262795349072,3927154
262799276685,610,2,receive,262795387010,3889675
262799277176,354,4,receive,262795405501,3871675
262799277631,110,3,receive,262795414267,3863364
262799442737,632,2,receive,262795398098,4044639
262799443237,344,2,receive,262795348014,4095223
262799443720,862,2,receive,262795319006,4124714
262799449332,638,2,receive,262795420640,4028692
262799449789,234,3,receive,262795361017,4088772
262799450256,422,3,receive,262795381926,4068330
262799450711,118,2,receive,262795369010,4081701
262799555195,134,3,receive,262795436763,4118432
262799555660,538,3,receive,262795418007,4137653
262799556124,640,1,receive,262795446205,4109919
262799556579,2,2,receive,262795380007,4176572
262799557056,432,3,receive,262795371008,4186048
262799557516,244,3,receive,262795375374,4182142
262799557970,852,2,receive,262795397064,4160906
262799677479,92,2,receive,262795439214,4238265
262799678020,814,2,receive,262795399084,4278936
262799678495,706,2,receive,262795460020,4218475
262799678967,760,2,receive,262795479730,4199237
262799679461,278,2,receive,262795462010,4217451
262799679934,628,3,receive,262795470139,4209795
262799680419,556,3,receive,262795491005,4189414
262799680890,384,3,receive,262795398006,4282884
262799809426,826,2,receive,262795477450,4331976
262799809888,928,2,receive,262795576207,4233681
262799810365,12,3,receive,262795520504,4289861
262799810826,968,2,receive,262795525987,4284839
262799811295,358,4,receive,262795483103,4328192
262799811761,934,2,receive,262795578622,4233139
262799921410,132,3,receive,262795587556,4333854
262799921880,588,2,receive,262795586010,4335870
262799922350,380,3,receive,262795602080,4320270
262799922817,366,3,receive,262795617548,4305269
262799923297,72,2,receive,262795661006,4262291
262799923767,984,2,receive,262795703009,4220758
262799924249,670,3,receive,262795667006,4257243
262800017868,810,3,receive,262795705012,4312856
262800018324,842,3,receive,262795695142,4323182
262800018784,638,3,receive,262795673010,4345774
262800019263,932,3,receive,262795651223,4368040
262800024469,68,2,receive,262795726773,4297696
262800024929,384,4,receive,262795759006,4265923
262800025434,434,1,receive,262795824114,4201320
262800025891,540,2,receive,262795717034,4308857
262800103858,354,5,receive,262795803308,4300550
262800104339,482,3,receive,262795802022,4302317
262800104816,78,3,receive,262795920480,4184336
262800105287,404,2,receive,262795844016,4261271
262800105754,774,2,receive,262795797214,4308540
262800106220,614,2,receive,262795875007,4231213
262800106685,212,3,receive,262795823591,4283094
262800204847,962,3,receive,262795837623,4367224
262800205317,14,3,receive,262795916384,4288933
262800205767,176,2,receive,262795955221,4250546
262800206232,102,3,receive,262795961136,4245096
262800206684,170,3,receive,262795947556,4259128
262800207145,976,3,receive,262796009550,4197595
262800282394,636,2,receive,262795923519,4358875
262800282876,856,2,receive,262795887511,4395365
262800283357,758,4,receive,262795999934,4283423
262800283824,900,3,receive,262796026714,4257110
262800284301,206,3,receive,262796116088,4168213
262800284772,58,3,receive,262796146617,4138155
262800339268,62,3,receive,262795971061,4368207
262800379579,830,3,receive,262796079181,4300398
262800380037,366,4,receive,262796008051,4371986
262800380483,688,3,receive,262796132214,4248269
262800380928,816,3,receive,262796254007,4126921
262800381382,494,5,receive,262796233006,4148376
262800381826,984,3,receive,262796193393,4188433
262800382281,910,3,receive,262796266713,4115568
262800382725,128,3,receive,262796113079,4269646
262800466941,646,1,receive,262796301996,4164945
262800467408,640,2,receive,262796297335,4170073
262800467869,164,4,receive,262796382202,4085667
262800483616,144,3,receive,262796397977,4085639
262800484067,928,4,receive,262796385011,4099056
262800484518,956,4,receive,262796334175,4150343
262800484960,842,4,receive,262796374006,4110954
262800485415,150,4,receive,262796388080,4097335
262800485859,708,5,receive,262796331006,4154853
262800602329,278,4,receive,262796326333,4275996
262800602766,844,3,receive,262796470031,4132735
262800603234,364,5,receive,262796450673,4152561
262800603687,540,3,receive,262796483579,4120108
262800604155,820,4,receive,262796479068,4125087
262800604609,628,4,receive,262796422277,4182332
262800692045,438,2,receive,262796519752,4172293
262800692494,680,3,receive,262796419064,4273430
262800693100,890,5,receive,262796511006,4182094
262800693562,618,4,receive,262796453328,4240234
262800694038,206,4,receive,262796604639,4089399
262800694490,630,3,receive,262796515741,4178749
262800694937,834,4,receive,262796536005,4158932
262800695414,838,7,receive,262796590130,4105284
262800695862,840,4,receive,262796551486,4144376
262800800341,110,5,receive,262796601580,4198761
262800800828,148,3,receive,262796602347,4198481
262800801316,472,4,receive,262796556221,4245095
262800801753,418,3,receive,262796740631,4061122
262800802247,852,4,receive,262796740796,4061451
262800802699,792,3,receive,262796712645,4090054
262800803163,890,6,receive,262796686200,4116963
262800803613,884,4,receive,262796736010,4067603
262800901468,788,6,receive,262796624794,4276674
262800901948,6,5,receive,262796729150,4172798
262800902434,836,3,receive,262796710657,4191777
262800902898,56,4,receive,262796841010,4061888
262800903369,960,4,receive,262796766251,4137118
262800903831,954,4,receive,262796769803,4134028
262800960730,910,4,receive,262796852255,4108475
262800961182,674,4,receive,262796804668,4156514
262800961615,822,4,receive,262796733796,4227819
262800962077,244,5,receive,262796866007,4096070
262800962546,768,4,receive,262796907006,4055540
262800963014,50,6,receive,262796931985,4031029
262800963473,152,3,receive,262796888726,4074747
262800963928,840,5,receive,262796921017,4042911
262801038333,992,3,receive,262796876220,4162113
262801038786,34,7,receive,262796841723,4197063
262801039251,80,7,receive,262796820009,4219242
262801039703,968,4,receive,262796803147,4236556
262801040166,944,4,receive,262797028171,4011995
262801040624,108,4,receive,262796923789,4116835
262801106596,866,4,receive,262796901011,4205585
262801107066,88,5,receive,262796935417,4171649
262801107524,992,4,receive,262797089688,4017836
262801107982,160,4,receive,262797035020,4072962
262801108460,726,5,receive,262797057569,4050891
262801108925,480,5,receive,262797055622,4053303
262801109393,898,4,receive,262797158200,3951193
262801109846,488,5,receive,262797122679,3987167
262801189327,916,4,receive,262797125556,4063771
262801189783,984,4,receive,262797171830,4017953
262801190247,980,3,receive,262797143453,4046794
262801190690,500,4,receive,262797199010,3991680
262801191144,464,4,receive,262797229744,3961400
262801191582,14,6,receive,262797244308,3947274
262801192026,54,4,receive,262797287009,3905017
262801192473,888,5,receive,262797288568,3903905
262801192919,926,4,receive,262797294004,3898915
262801294357,906,5,receive,262797257410,4036947
262801294809,956,6,receive,262797249006,4045803
262801295281,12,5,receive,262797334312,3960969
262801295730,910,5,receive,262797331606,3964124
262801296190,712,5,receive,262797341824,3954366
262801296645,872,6,receive,262797379901,3916744
262801356120,74,6,receive,262797345157,4010963
262801356563,892,5,receive,262797367262,3989301
262801356994,818,6,receive,262797336009,4020985
262801357437,18,5,receive,262797434442,3922995
262801357866,588,4,receive,262797504010,3853856
262801358338,348,8,receive,262797486091,3872247
262801358798,844,4,receive,262797455509,3903289
262801359265,392,6,receive,262797488333,3870932
262801359718,608,4,receive,262797463009,3896709
262801453702,774,5,receive,262797510136,3943566
262801454176,218,6,receive,262797524121,3930055
262801454625,740,4,receive,262797399482,4055143
262801455091,766,4,receive,262797581256,3873835
262801455552,420,5,receive,262797540006,3915546
262801456018,682,6,receive,262797634371,3821647
262801456481,936,4,receive,262797589090,3867391
262801456939,46,5,receive,262797558805,3898134
262801537936,680,5,receive,262797708978,3828958
262801538408,658,2,receive,262797731385,3807023
262801538866,940,5,receive,262797690967,3847899
262801539339,868,5,receive,262797581292,3958047
262801539798,606,5,receive,262797775332,3764466
262801557162,6,6,receive,262797764984,3792178
262801557602,92,5,receive,262797638603,3918999
262801620887,454,6,receive,262797754223,3866664
262801621347,712,6,receive,262797744490,3876857
262801621797,230,5,receive,262797871340,3750457
262801622278,422,6,receive,262797824784,3797494
262801622746,638,6,receive,262797904012,3718734
262801623227,290,6,receive,262797793356,3829871
262801623697,946,5,receive,262797842205,3781492
262801692417,948,6,receive,262797863448,3828969
262801692871,768,6,receive,262797908010,3784861
262801693341,80,9,receive,262797883481,3809860
262801693795,882,5,receive,262798019620,3674175
262801700595,904,6,receive,262798049137,3651458
262801701060,6,7,receive,262798078023,3623037
262801701538,278,7,receive,262798091337,3610201
262801701997,730,6,receive,262798035341,3666656
262801768473,32,5,receive,262798074006,3694467
262801768934,780,6,receive,262798117006,3651928
262801769413,860,5,receive,262798119006,3650407
262801769874,894,6,receive,262798113008,3656866
262801770348,852,7,receive,262798011260,3759088
262801770815,956,8,receive,262798118257,3652558
262801833326,218,7,receive,262797883487,3949839
262801833790,898,5,receive,262798007299,3826491
262801834275,28,6,receive,262798002012,3832263
262801834740,56,6,receive,262798083011,3751729
262801847980,36,6,receive,262798221813,3626167
262801861103,226,5,receive,262798240452,3620651
262801901269,98,7,receive,262798274158,3627111
262801901713,526,6,receive,262798204049,3697664
262801902176,612,6,receive,262798191272,3710904
262801902625,558,7,receive,262798236336,3666289
262801903090,768,7,receive,262798280010,3623080
262801903542,668,1,receive,262798396130,3507412
262801903991,660,3,receive,262798294020,3609971
262801904446,744,7,receive,262798389410,3515036
262801904894,490,3,receive,262798182798,3722096
262801986440,714,6,receive,262798322011,3664429
262801986874,766,6,receive,262798404075,3582799
262801987320,758,9,receive,262798373309,3614011
262801987780,466,9,receive,262798472538,3515242
262801994253,610,6,receive,262798489962,3504291
262801994710,852,8,receive,262798453389,3541321
262801995173,552,7,receive,262798481006,3514167
262801995636,768,8,receive,262798450398,3545238
262802070574,236,6,receive,262798456411,3614163
262802071043,42,9,receive,262798483012,3588031
262802071497,964,6,receive,262798531620,3539877
262802071943,588,6,receive,262798559017,3512926
262802072407,712,7,receive,262798490988,3581419
262802072855,826,6,receive,262798457009,3615846
262802089901,926,6,receive,262798545801,3544100
262802090366,592,8,receive,262798494468,3595898
262802090828,666,6,receive,262798563008,3527820
262802142670,60,7,receive,262798527270,3615400
262802143199,968,6,receive,262798667346,3475853
262802147320,862,8,receive,262798686009,3461311
262802163524,946,7,receive,262798641106,3522418
262802163971,66,6,receive,262798607728,3556243
262802164442,454,7,receive,262798607149,3557293
262802164901,958,7,receive,262798617006,3547895
262802221069,12,7,receive,262798523212,3697857
262802221523,22,6,receive,262798712313,3509210
262802221973,146,6,receive,262798880624,3341349
262802227580,450,7,receive,262798880444,3347136
262802228030,290,7,receive,262798803095,3424935
262802228470,394,5,receive,262798781128,3447342
262802228907,134,8,receive,262798801828,3427079
262802296611,228,5,receive,262798853268,3443343
262802297083,586,9,receive,262798903016,3394067
262802297547,390,6,receive,262798873254,3424293
262802298944,578,9,receive,262798904005,3394939
262802299418,596,10,receive,262798860638,3438780
262802299879,768,9,receive,262798837950,3461929
262802300350,976,9,receive,262798909160,3391190
262802300807,828,6,receive,262798908379,3392428
262802385291,760,10,receive,262798881592,3503699
262802385752,842,8,receive,262798938069,3447683
262802386228,772,9,receive,262798918442,3467786
262802386684,22,7,receive,262798868142,3518542
262802387144,886,7,receive,262799019522,3367622
262802404148,778,9,receive,262799015708,3388440
262802404606,618,7,receive,262799050614,3353992
262802463089,42,10,receive,262798987442,3475647
262802463542,722,9,receive,262799034016,3429526
262802463985,140,7,receive,262799083605,3380380
262802464446,992,8,receive,262799053052,3411394
262802464888,24,8,receive,262799112013,3352875
262802465364,280,8,receive,262799103006,3362358
262802465828,914,6,receive,262799098255,3367573
262802466316,998,8,receive,262799117011,3349305
262802466781,878,6,receive,262799115010,3351771
262802573215,736,9,receive,262799175801,3397414
262802573693,248,3,receive,262799119889,3453804
262802574181,276,7,receive,262799442254,3131927
262802574650,454,8,receive,262799446258,3128392
262802575137,688,6,receive,262799347133,3228004
262802575606,608,7,receive,262799400428,3175178
262802638007,556,9,receive,262799456009,3181998
262802638494,482,8,receive,262799380084,3258410
262802638959,816,9,receive,262799382006,3256953
262802639428,288,8,receive,262799374818,3264610
262802639885,930,8,receive,262799464405,3175480
262802640354,542,8,receive,262799468009,3172345
262802640818,70,8,receive,262799419015,3221803
262802709802,614,8,receive,262799396430,3313372
262802710286,612,8,receive,262799406256,3304030
262802710755,104,8,receive,262799349058,3361697
262802711230,590,10,receive,262799371635,3339595
262802711704,610,7,receive,262799519011,3192693
262802712184,724,8,receive,262799495101,3217083
262802775224,582,9,receive,262799539008,3236216
262802775694,852,9,receive,262799510402,3265292
262802776170,588,8,receive,262799534054,3242116
262802776639,154,4,receive,262799456550,3320089
262802777109,636,6,receive,262799506493,3270616
262802777574,30,8,receive,262799641164,3136410
262802778049,402,5,receive,262799584011,3194038
262802778519,502,4,receive,262799475077,3303442
262802778985,954,8,receive,262799690339,3088646
262802853107,590,11,receive,262799617541,3235566
262802853582,76,12,receive,262799680167,3173415
262802854051,316,2,receive,262799657007,3197044
262802854518,552,9,receive,262799681006,3173512
262802854973,850,8,receive,262799809159,3045814
262802855445,140,8,receive,262799827844,3027601
262802913290,538,9,receive,262799800960,3112330
262802913749,8,9,receive,262799677534,3236215
262802914215,936,7,receive,262799767006,3147209
262802914671,578,10,receive,262799826340,3088331
262802915181,820,10,receive,262799805852,3109329
262802915636,740,8,receive,262799870142,3045494
262802970709,622,7,receive,262799848742,3121967
262802971191,552,10,receive,262799918971,3052220
262802971642,906,9,receive,262799870150,3101492
262802972117,916,9,receive,262799883964,3088153
262802972586,466,11,receive,262799915749,3056837
262802973057,448,1,receive,262800020157,2952900
262802973514,802,8,receive,262800027640,2945874
262802973979,114,8,receive,262800001013,2972966
262803028326,470,3,receive,262799992606,3035720
262803028781,752,8,receive,262800036065,2992716
262803029250,290,10,receive,262800043005,2986245
262803029707,894,9,receive,262799984013,3045694
262803030183,660,6,receive,262800034075,2996108
262803046027,154,5,receive,262799972044,3073983
262803093033,520,10,receive,262800061167,3031866
262803093495,22,9,receive,262800035712,3057783
262803093942,668,4,receive,262800077713,3016229
262803094440,900,9,receive,262799974410,3120030
262803094909,658,6,receive,262800051467,3043442
262803095386,438,7,receive,262800076444,3018942
262803095856,98,12,receive,262800226065,2869791
262803096334,946,10,receive,262800242547,2853787
262803096798,118,9,receive,262800236043,2860755
262803167306,362,9,receive,262800187005,2980301
262803167757,848,9,receive,262800217401,2950356
262803168217,606,8,receive,262800084067,3084150
262803168696,268,2,receive,262800245176,2923520
262803169178,892,10,receive,262800170099,2999079
262803169653,618,10,receive,262800257544,2912109
262803170137,864,10,receive,262800278527,2891610
262803170600,782,11,receive,262800272023,2898577
262803230441,534,8,receive,262800154454,3075987
262803230906,622,8,receive,262800335133,2895773
262803231382,30,9,receive,262800303792,2927590
262803231853,60,10,receive,262800298304,2933549
262803232358,382,9,receive,262800384815,2847543
262803232817,842,11,receive,262800384741,2848076
262803233287,786,10,receive,262800373578,2859709
262803233748,20,10,receive,262800355014,2878734
262803298246,280,10,receive,262800335871,2962375
262803298702,136,8,receive,262800334368,2964334
262803299188,840,12,receive,262800465006,2834182
262803299651,814,11,receive,262800403007,2896644
262803300124,288,10,receive,262800464791,2835333
262803300584,48,9,receive,262800440081,2860503
262803301054,930,11,receive,262800391751,2909303
262803301522,362,10,receive,262800474577,2826945
262803301979,84,10,receive,262800432794,2869185
262803367078,790,11,receive,262800446553,2920525
262803367550,122,8,receive,262800501006,2866544
262803368029,228,8,receive,262800587938,2780091
262803368499,32,10,receive,262800546171,2822328
262803368967,646,8,receive,262800601277,2767690
262803388674,968,8,receive,262800602819,2785855
262803426170,14,12,receive,262800554007,2872163
262803426634,54,8,receive,262800571272,2855362
262803427107,210,9,receive,262800567127,2859980
262803427576,220,8,receive,262800647006,2780570
262803428051,816,11,receive,262800497014,2931037
262803428523,472,9,receive,262800627960,2800563
262803428986,930,12,receive,262800661685,2767301
262803429460,568,9,receive,262800610711,2818749
262803429922,182,2,receive,262800706297,2723625
262803501400,144,8,receive,262800657434,2843966
262803501833,180,2,receive,262800655786,2846047
262803502297,206,12,receive,262800709411,2792886
262803502754,580,9,receive,262800784039,2718715
262803503220,422,11,receive,262800800216,2703004
262803503672,324,3,receive,262800808776,2694896
262803504131,534,9,receive,262800797068,2707063
262803504577,212,15,receive,262800763008,2741569
262803580903,926,10,receive,262800816095,2764808
262803581371,932,9,receive,262800706315,2875056
262803581827,906,10,receive,262800914077,2667750
262803582302,344,12,receive,262800936391,2645911
262803582760,10,10,receive,262800967699,2615061
262803583244,628,15,receive,262800963270,2619974
262803583722,202,11,receive,262800964009,2619713
262803648788,876,10,receive,262800845679,2803109
262803649233,12,10,receive,262800954007,2695226
262803649662,328,2,receive,262800960006,2689656
262803650094,414,5,receive,262800940007,2710087
262803650528,166,11,receive,262800935736,2714792
262803650953,552,12,receive,262800908874,2742079
262803651391,86,10,receive,262800925081,2726310
262803651816,614,10,receive,262800957846,2693970
262803714287,444,11,receive,262800946080,2768207
262803714703,98,13,receive,262801108066,2606637
262803715133,436,3,receive,262801034722,2680411
262803715550,262,12,receive,262801073101,2642449
262803715971,104,11,receive,262801099017,2616954
262803716420,194,6,receive,262801073850,2642570
262803716853,332,2,receive,262801049829,2667024
262803767320,212,16,receive,262801105319,2662001
262803767757,110,14,receive,262801086048,2681709
262803768218,272,4,receive,262801082098,2686120
262803768663,986,12,receive,262801067192,2701471
262803769118,954,10,receive,262801058203,2710915
262803769571,136,9,receive,262801138663,2630908
262803823035,406,8,receive,262801113010,2710025
262803823482,60,11,receive,262801139142,2684340
262803823912,940,11,receive,262801144185,2679727
262803824363,960,10,receive,262801210578,2613785
262803824805,214,3,receive,262801116341,2708464
262803825291,192,1,receive,262801228469,2596822
262803825756,982,13,receive,262801152262,2673494
262803826219,268,3,receive,262801196443,2629776
262803826673,898,10,receive,262801205634,2621039
262803886141,744,11,receive,262801165215,2720926
262803886576,234,15,receive,262801122004,2764572
262803887023,526,11,receive,262801295007,2592016
262803887472,28,11,receive,262801290006,2597466
262803887932,816,12,receive,262801318878,2569054
262803888406,920,9,receive,262801274089,2614317
262803888864,976,13,receive,262801276010,2612854
262803935159,762,12,receive,262801342527,2592632
262803935615,372,14,receive,262801207207,2728408
262803936080,932,10,receive,262801345131,2590949
262803936543,670,14,receive,262801372006,2564537
262803942467,694,1,receive,262801375057,2567410
262803942905,722,14,receive,262801372091,2570814
262803943354,18,11,receive,262801359967,2583387
262803943791,102,10,receive,262801365705,2578086
262804002434,884,12,receive,262801340825,2661609
262804002887,252,6,receive,262801384081,2618806
262804003392,654,10,receive,262801418932,2584460
262804003853,244,12,receive,262801458715,2545138
262804004320,874,13,receive,262801432403,2571917
262804004783,910,11,receive,262801435365,2569418
262804043579,100,12,receive,262801478822,2564757
262804044027,792,13,receive,262801442126,2601901
262804044467,356,15,receive,262801481491,2562976
262804044901,586,13,receive,262801431009,2613892
262804045352,272,5,receive,262801611511,2433841
262804045784,872,11,receive,262801487642,2558142
262804046227,878,10,receive,262801586144,2460083
262804046686,178,10,receive,262801596678,2450008
262804108265,242,1,receive,262801630611,2477654
262804108701,172,9,receive,262801571447,2537254
262804109147,466,14,receive,262801593071,2516076
262804109587,126,11,receive,262801621793,2487794
262804110044,88,13,receive,262801546005,2564039
262804110505,436,4,receive,262801610268,2500237
262804110955,380,11,receive,262801638090,2472865
262804111413,694,2,receive,262801627410,2484003
262804111871,386,2,receive,262801602733,2509138
262804172261,738,11,receive,262801572278,2599983
262804172714,188,2,receive,262801674839,2497875
262804173173,914,11,receive,262801667277,2505896
262804173621,214,4,receive,262801660005,2513616
262804174081,500,12,receive,262801711825,2462256
262804174538,392,12,receive,262801715740,2458798
262804174991,588,11,receive,262801579453,2595538
262804219641,2,12,receive,262801610466,2609175
262804220121,632,13,receive,262801650926,2569195
262804220579,84,12,receive,262801778080,2442499
262804221047,944,11,receive,262801784337,2436710
262804221508,268,4,receive,262801782195,2439313
262804221965,974,11,receive,262801763223,2458742
262804222436,232,7,receive,262801730688,2491748
262804222901,44,11,receive,262801765973,2456928
262804276504,558,12,receive,262801838599,2437905
262804276944,918,14,receive,262801783767,2493177
262804277387,950,14,receive,262801795011,2482376
262804277829,948,11,receive,262801841950,2435879
262804278291,494,13,receive,262801797398,2480893
262804278749,308,2,receive,262801851823,2426926
262804334202,536,12,receive,262801832076,2502126
262804334650,272,6,receive,262801886839,2447811
262804335091,538,13,receive,262801911141,2423950
262804335535,874,14,receive,262801911854,2423681
262804335974,442,13,receive,262801877743,2458231
262804336425,954,11,receive,262801794012,2542413
262804336866,744,12,receive,262801915816,2421050
262804337330,560,10,receive,262801888596,2448734
262804337781,88,14,receive,262801897687,2440094
262804391802,952,14,receive,262801968318,2423484
262804392281,324,5,receive,262801920930,2471351
262804392737,970,10,receive,262802001007,2391730
262804393205,806,10,receive,262801957005,2436200
262804393663,562,12,receive,262801973068,2420595
262804404206,274,14,receive,262801839060,2565146
262804411795,980,12,receive,262802012006,2399789
262804439270,8,14,receive,262801987291,2451979
262804439740,826,14,receive,262802094341,2345399
262804440224,586,14,receive,262802074255,2365969
262804440686,246,2,receive,262802089469,2351217
262804441163,74,14,receive,262802101446,2339717
262804441623,788,15,receive,262802125008,2316615
262804442089,444,13,receive,262802080341,2361748
262804442552,236,11,receive,262802084174,2358378
262804495233,174,15,receive,262802097765,2397468
262804495705,658,9,receive,262802103846,2391859
262804496174,244,13,receive,262802105010,2391164
262804496648,180,5,receive,262802096192,2400456
262804497116,262,13,receive,262802085428,2411688
262804497577,950,15,receive,262802116375,2381202
262804498047,332,3,receive,262802110557,2387490
262804498515,932,11,receive,262802034012,2464503
262804498977,726,14,receive,262802096679,2402298
262804534894,402,11,receive,262802222265,2312629
262804535367,806,11,receive,262802209005,2326362
262804535832,998,12,receive,262802215857,2319975
262804536308,390,12,receive,262802245005,2291303
262804536770,660,10,receive,262802197136,2339634
262804575014,956,14,receive,262802187923,2387091
262804575475,568,12,receive,262802255005,2320470
262804575927,188,3,receive,262802272200,2303727
262804599802,102,11,receive,262802259010,2340792
262804605250,414,7,receive,262802284510,2320740
262804605694,994,13,receive,262802275309,2330385
262804606164,708,15,receive,262802278351,2327813
262804625316,210,12,receive,262802293945,2331371
262804636391,946,13,receive,262802218437,2417954
262804636830,942,11,receive,262802265526,2371304
262804646500,86,12,receive,262802390804,2255696
262804646931,662,6,receive,262802396010,2250921
262804655117,58,14,receive,262802335605,2319512
262804659568,202,13,receive,262802396975,2262593
262804671151,974,12,receive,262802373244,2297907
262804671590,148,12,receive,262802408725,2262865
262804672027,270,1,receive,262802381523,2290504
262804672455,682,13,receive,262802458345,2214110
262804672904,64,11,receive,262802341096,2331808
262804724377,562,13,receive,262802421237,2303140
262804724802,212,18,receive,262802442007,2282795
262804725241,390,13,receive,262802434636,2290605
262804725695,990,12,receive,262802476535,2249160
262804726137,384,15,receive,262802477560,2248577
262804726577,868,12,receive,262802473006,2253571
262804762176,66,12,receive,262802444327,2317849
262804762644,556,14,receive,262802624153,2138491
262804763099,816,15,receive,262802601547,2161552
262804763560,308,4,receive,262802650570,2112990
262804773752,948,12,receive,262802473367,2300385
262804784041,342,3,receive,262802649555,2134486
262804784490,560,11,receive,262802637060,2147430
262804784925,662,7,receive,262802658444,2126481
262804811405,962,15,receive,262802627149,2184256
262804811982,166,14,receive,262802646303,2165679
262804819128,534,11,receive,262802588408,2230720
262804819593,470,9,receive,262802624811,2194782
262804820057,864,14,receive,262802668709,2151348
262804820524,596,15,receive,262802599152,2221372
262804820979,312,4,receive,262802694127,2126852
