receive_timestamp,source_vehicle,message_id,event_type,send_timestamp,latency_us
262805399611,12,1,receive,262794651507,10748104
262805400332,372,1,receive,262794651592,10748740
262805400969,156,1,receive,262794652107,10748862
262805401624,198,1,receive,262794652771,10748853
262805402285,186,1,receive,262794653417,10748868
262805417831,16,1,receive,262794654371,10763460
262805448353,376,1,receive,262794656043,10792310
262805449005,582,1,receive,262794656105,10792900
262805450545,380,1,receive,262794656620,10793925
262805451208,210,1,receive,262794657065,10794143
262805451859,580,1,receive,262794657773,10794086
262805488598,218,1,receive,262794659052,10829546
262805489267,596,1,receive,262794659861,10829406
262805490114,50,1,receive,262794660037,10830077
262805500650,76,1,receive,262794660045,10840605
262805523815,44,1,receive,262794661029,10862786
262805524477,592,1,receive,262794664405,10860072
262805525133,420,1,receive,262794665047,10860086
262805525772,588,1,receive,262794665889,10859883
262805526429,150,1,receive,262794668319,10858110
262805570487,632,1,receive,262794668908,10901579
262805571171,164,1,receive,262794669151,10902020
262805571829,384,1,receive,262794669749,10902080
262805572490,14,1,receive,262794650105,10922385
262805573144,542,1,receive,262794672968,10900176
262805605335,628,1,receive,262794676074,10929261
262805606025,52,1,receive,262794677035,10928990
262805606702,590,1,receive,262794679633,10927069
262805607376,170,1,receive,262794680405,10926971
262805608052,226,1,receive,262794680969,10927083
262805608704,364,1,receive,262794682340,10926364
262805654375,10,1,receive,262794651651,11002724
262805655053,88,1,receive,262794684352,10970701
262805655724,134,1,receive,262794684917,10970807
262805656404,358,1,receive,262794685038,10971366
262805678653,120,1,receive,262794685420,10993233
262805679347,758,1,receive,262794685979,10993368
262805680007,166,1,receive,262794688499,10991508
262805686560,208,1,receive,262794691855,10994705
262805687239,344,1,receive,262794693037,10994202
262805721723,832,1,receive,262794694048,11027675
262805722397,794,1,receive,262794695138,11027259
262805723042,442,1,receive,262794697452,11025590
262805723688,450,1,receive,262794698023,11025665
262805724335,162,1,receive,262794700773,11023562
262805724983,802,1,receive,262794702973,11022010
262805771231,812,1,receive,262794703956,11067275
262805776961,834,1,receive,262794704045,11072916
262805777616,126,1,receive,262794705053,11072563
262805788561,824,1,receive,262794709244,11079317
262805817618,818,1,receive,262794710825,11106793
262805818367,552,1,receive,262794712774,11105593
262805819044,752,1,receive,262794715035,11104009
262805832047,274,1,receive,262794718059,11113988
262805832728,830,1,receive,262794719284,11113444
262805866888,480,1,receive,262794719296,11147592
262805867574,822,1,receive,262794719860,11147714
262805868249,618,1,receive,262794721795,11146454
262805868921,520,1,receive,262794730338,11138583
262805902618,630,1,receive,262794730659,11171959
262805903166,500,1,receive,262794731099,11172067
262805903755,526,1,receive,262794732762,11170993
262805904409,348,1,receive,262794733707,11170702
262805905095,508,1,receive,262794734772,11170323
262805905746,836,1,receive,262794737218,11168528
262805950626,792,1,receive,262794738039,11212587
262805951373,762,1,receive,262794738054,11213319
262805952050,820,1,receive,262794738579,11213471
262805970610,168,1,receive,262794739068,11231542
262805993650,454,1,receive,262794739055,11254595
262805994178,354,1,receive,262794739204,11254974
262805994831,840,1,receive,262794739718,11255113
262805995498,388,1,receive,262794699467,11296031
262806017255,488,1,receive,262794741721,11275534
262806041383,92,1,receive,262794651844,11389539
262806042066,816,1,receive,262794745511,11296555
262806042722,202,1,receive,262794745539,11297183
262806054093,244,1,receive,262794745732,11308361
262806063492,212,1,receive,262794749217,11314275
262806089952,432,1,receive,262794657302,11432650
262806090629,178,1,receive,262794679202,11411427
262806091487,352,1,receive,262794747193,11344294
262806101029,610,1,receive,262794753207,11347822
262806111285,634,1,receive,262794756062,11355223
262806141266,540,1,receive,262794759061,11382205
262806141951,786,1,receive,262794759277,11382674
262806142597,494,1,receive,262794759442,11383155
262806143128,482,1,receive,262794759783,11383345
262806143629,838,1,receive,262794760973,11382656
262806162483,736,1,receive,262794761059,11401424
262806182054,712,1,receive,262794765916,11416138
262806182720,606,1,receive,262794767049,11415671
262806183389,594,1,receive,262794771037,11412352
262806238152,62,1,receive,262794771460,11466692
262806238817,236,1,receive,262794669024,11569793
262806239543,356,1,receive,262794775038,11464505
262806251075,724,1,receive,262794775084,11475991
262806251736,722,1,receive,262794775712,11476024
262806291469,788,1,receive,262794776734,11514735
262806292136,638,1,receive,262794777049,11515087
262806292799,466,1,receive,262794779063,11513736
262806293471,754,1,receive,262794779855,11513616
262806354050,744,1,receive,262794782098,11571952
262806354716,718,1,receive,262794784101,11570615
262806355384,58,1,receive,262794634580,11720804
262806356049,852,1,receive,262794785938,11570111
262806356709,842,1,receive,262794787098,11569611
262806357388,140,1,receive,262794705034,11652354
262806425045,874,1,receive,262794790712,11634333
262806425744,608,1,receive,262794791047,11634697
262806426437,740,1,receive,262794791185,11635252
262806427131,862,1,receive,262794791404,11635727
262806427826,586,1,receive,262794773034,11654792
262806479792,680,1,receive,262794800964,11678828
262806480485,556,1,receive,262794801210,11679275
262806481177,80,1,receive,262794753077,11728100
262806481842,810,1,receive,262794800687,11681155
262806482514,682,1,receive,262794803273,11679241
262806539462,848,1,receive,262794804357,11735105
262806540152,688,1,receive,262794805146,11735006
262806540834,670,1,receive,262794805425,11735409
262806541511,706,1,receive,262794805754,11735757
262806542192,532,1,receive,262794804039,11738153
262806583173,866,1,receive,262794807290,11775883
262806583859,846,1,receive,262794808433,11775426
262806584528,700,1,receive,262794808661,11775867
262806585193,666,1,receive,262794808832,11776361
262806630277,726,1,receive,262794809152,11821125
262806630972,886,1,receive,262794809654,11821318
262806631647,280,1,receive,262794804038,11827609
262806632321,534,1,receive,262794810019,11822302
262806632982,742,1,receive,262794810046,11822936
262806633652,734,1,receive,262794805975,11827677
262806687585,738,1,receive,262794804564,11883021
262806688258,578,1,receive,262794813571,11874687
262806688921,614,1,receive,262794818064,11870857
262806689582,766,1,receive,262794818592,11870990
262806729629,814,1,receive,262794819547,11910082
262806730320,760,1,receive,262794820818,11909502
262806733848,620,1,receive,262794817830,11916018
262806744044,864,1,receive,262794816273,11927771
262806752912,612,1,receive,262794824582,11928330
262806782138,768,1,receive,262794826059,11956079
262806782819,472,1,receive,262794824203,11958616
262806783508,890,1,receive,262794828041,11955467
262806797857,902,1,receive,262794828444,11969413
262806802759,878,1,receive,262794829373,11973386
262806835251,558,1,receive,262794826751,12008500
262806835917,882,1,receive,262794827769,12008148
262806836584,730,1,receive,262794831114,12005470
262806837248,780,1,receive,262794831798,12005450
262806837903,32,1,receive,262794664030,12173873
262806885520,174,1,receive,262794707028,12178492
262806886214,538,1,receive,262794831395,12054819
262806886901,774,1,receive,262794834551,12052350
262806887646,782,1,receive,262794831156,12056490
262806932930,636,1,receive,262794835757,12097173
262806933616,230,1,receive,262794836017,12097599
262806934299,568,1,receive,262794828903,12105396
262806951813,276,1,receive,262794718788,12233025
262806973706,184,1,receive,262794837518,12136188
262806974384,888,1,receive,262794838015,12136369
262806975056,708,1,receive,262794823509,12151547
262806975724,704,1,receive,262794836511,12139213
262806976384,536,1,receive,262794827439,12148945
262807026416,884,1,receive,262794818675,12207741
262807027114,880,1,receive,262794828803,12198311
262807027801,856,1,receive,262794841630,12186171
262807028487,674,1,receive,262794842731,12185756
262807045461,678,1,receive,262794849031,12196430
262807076840,868,1,receive,262794833809,12243031
262807077501,698,1,receive,262794848604,12228897
262807078171,806,1,receive,262794853081,12225090
262807088021,778,1,receive,262794855512,12232509
262807095633,720,1,receive,262794843242,12252391
262807105378,844,1,receive,262794842017,12263361
262807110294,900,1,receive,262794839300,12270994
262807115765,464,1,receive,262794827781,12287984
262807124734,804,1,receive,262794860983,12263751
262807142240,444,1,receive,262794861645,12280595
262807142902,790,1,receive,262794850137,12292765
262807143574,896,1,receive,262794858653,12284921
262807144278,870,1,receive,262794831029,12313249
262807144835,912,1,receive,262794858038,12286797
262807145392,116,1,receive,262794852130,12293262
262807209980,716,1,receive,262794853883,12356097
262807210550,876,1,receive,262794852260,12358290
262807211118,732,1,receive,262794852037,12359081
262807211745,854,1,receive,262794864460,12347285
262807212385,914,1,receive,262794874858,12337527
262807263754,828,1,receive,262794871988,12391766
262807264393,910,1,receive,262794873486,12390907
262807265038,892,1,receive,262794863422,12401616
262807265691,600,1,receive,262794874615,12391076
262807266348,124,2,receive,262794780600,12485748
262807307076,924,1,receive,262794879157,12427919
262807307736,918,1,receive,262794884191,12423545
262807308396,858,1,receive,262794875062,12433334
262807322029,628,2,receive,262794887482,12434547
262807329647,222,1,receive,262794858074,12471573
262807353593,826,1,receive,262794888886,12464707
262807354263,908,1,receive,262794887953,12466310
262807354921,916,1,receive,262794895909,12459012
262807355580,898,1,receive,262794897612,12457968
262807356241,206,1,receive,262794894084,12462157
262807356894,906,1,receive,262794896323,12460571
262807410082,176,1,receive,262794885163,12524919
262807410731,850,1,receive,262794880639,12530092
262807411376,702,1,receive,262794859037,12552339
262807412026,920,1,receive,262794906037,12505989
262807412678,904,1,receive,262794898967,12513711
262807455876,104,1,receive,262794693040,12762836
262807456533,894,1,receive,262794910035,12546498
262807457185,714,1,receive,262794869932,12587253
262807457863,432,2,receive,262794897567,12560296
262807458516,362,1,receive,262794890412,12568104
262807507455,74,2,receive,262794891949,12615506
262807508116,138,1,receive,262794906230,12601886
262807508761,872,1,receive,262794868647,12640114
262807509416,926,1,receive,262794922243,12587173
262807510068,860,1,receive,262794864783,12645285
262807510714,928,1,receive,262794926348,12584366
262807558752,922,1,receive,262794927383,12631369
262807559414,442,2,receive,262794921009,12638405
262807560248,172,1,receive,262794871811,12688437
262807570035,152,1,receive,262794921274,12648761
262807595982,820,2,receive,262794926445,12669537
262807596647,562,1,receive,262794948009,12648638
262807597417,378,1,receive,262794945663,12651754
262807605740,114,1,receive,262794899455,12706285
262807615728,758,2,receive,262794953280,12662448
262807643028,110,2,receive,262794921860,12721168
262807643693,148,1,receive,262794843310,12800383
262807644347,772,1,receive,262794960625,12683722
262807644993,212,2,receive,262794923249,12721744
262807645640,354,2,receive,262794884812,12760828
262807646288,938,1,receive,262794965518,12680770
262807646934,736,2,receive,262794901012,12745922
262807701216,934,1,receive,262794966837,12734379
262807701867,580,2,receive,262794955918,12745949
262807702522,888,2,receive,262794981489,12721033
262807703178,956,1,receive,262794984049,12719129
262807703826,508,2,receive,262794961472,12742354
262807744875,262,2,receive,262794986507,12758368
262807745590,962,1,receive,262794987230,12758360
262807746247,220,1,receive,262794979264,12766983
262807746901,838,2,receive,262794990251,12756650
262807747555,930,1,receive,262794990426,12757129
262807792237,700,2,receive,262794990760,12801477
262807792881,418,1,receive,262794895366,12897515
262807793736,12,2,receive,262794920545,12873191
262807802332,958,1,receive,262794999239,12803093
262807809738,964,1,receive,262795001085,12808653
262807834323,954,1,receive,262795002131,12832192
262807835068,948,1,receive,262795005276,12829792
262807835715,950,1,receive,262795006730,12828985
262807836379,944,1,receive,262795008940,12827439
262807870449,952,1,receive,262795010977,12859472
262807871120,358,2,receive,262795011078,12860042
262807871776,942,1,receive,262795012579,12859197
262807872428,20,2,receive,262794917166,12955262
262807890097,946,1,receive,262795013041,12877056
262807915458,404,1,receive,262795004819,12910639
262807916129,960,1,receive,262795017037,12899092
262807916784,162,2,receive,262795004120,12912664
262807917434,586,2,receive,262795027329,12890105
262807918069,98,2,receive,262794964568,12953501
262807918727,940,1,receive,262795036121,12882606
262807959892,210,2,receive,262794982172,12977720
262807960552,78,2,receive,262795022226,12938326
262807961213,830,2,receive,262794976027,12985186
262807961867,518,4,receive,262805438335,2523532
262807962527,516,1,receive,262805438809,2523718
262808003789,250,2,receive,262805450472,2553317
262808004447,374,6,receive,262805446133,2558314
262808005101,238,8,receive,262805456699,2548402
262808005753,396,1,receive,262805450533,2555220
262808024020,664,3,receive,262805459394,2564626
262808044948,298,6,receive,262805458122,2586826
262808045550,514,4,receive,262805442693,2602857
262808046183,544,3,receive,262805458288,2587895
262808054012,410,7,receive,262805487390,2566622
262808061347,266,6,receive,262805488127,2573220
262808069220,370,5,receive,262805466631,2602589
262808096613,486,2,receive,262805510844,2585769
262808097307,390,18,receive,262805497928,2599379
262808097973,306,6,receive,262805502007,2595966
262808098658,284,6,receive,262805520061,2578597
262808099343,214,9,receive,262805441671,2657672
262808140300,550,3,receive,262805548354,2591946
262808140992,656,11,receive,262805552326,2588666
262808141682,296,10,receive,262805553935,2587747
262808142369,368,4,receive,262805552363,2590006
262808143055,528,1,receive,262805579475,2563580
262808143720,490,15,receive,262805554147,2589573
262808187180,192,7,receive,262805559144,2628036
262808187861,318,4,receive,262805547320,2640541
262808188524,180,10,receive,262805599423,2589101
262808189185,452,6,receive,262805592279,2596906
262808189840,522,3,receive,262805602304,2587536
262808232773,746,1,receive,262805617836,2614937
262808233440,370,6,receive,262805627983,2605457
262808234113,456,2,receive,262805618226,2615887
262808234785,412,5,receive,262805654532,2580253
262808235472,484,3,receive,262805610010,2625462
262808274600,692,4,receive,262805654779,2619821
262808275268,414,14,receive,262805664270,2610998
262808275947,502,16,receive,262805669618,2606329
262808276617,696,8,receive,262805664809,2611808
262808277290,492,5,receive,262805668411,2608879
262808322276,770,1,receive,262805703343,2618933
262808322959,200,3,receive,262805697750,2625209
262808323642,616,3,receive,262805698166,2625476
262808334991,242,10,receive,262805713537,2621454
262808335680,458,5,receive,262805717705,2617975
262808364855,328,10,receive,262805731066,2633789
262808365541,664,4,receive,262805710121,2655420
262808366253,4,4,receive,262805783907,2582346
262808366928,584,1,receive,262805774020,2592908
262808367598,300,8,receive,262805751078,2616520
262808408941,338,7,receive,262805771590,2637351
262808409622,296,11,receive,262805782010,2627612
262808410306,498,6,receive,262805813633,2596673
262808410983,272,12,receive,262805826186,2584797
262808429460,250,3,receive,262805827783,2601677
262808429995,270,8,receive,262805819842,2610153
262808456659,470,15,receive,262805861007,2595652
262808457309,460,5,receive,262805805381,2651928
262808457961,516,2,receive,262805863008,2594953
262808458638,616,4,receive,262805870455,2588183
262808501329,672,5,receive,262805877126,2624203
262808501990,374,7,receive,262805823070,2678920
262808502672,566,1,receive,262805908526,2594146
262808503341,602,2,receive,262805830687,2672654
262808543608,256,7,receive,262805912007,2631601
262808544298,260,2,receive,262805924474,2619824
262808544985,490,16,receive,262805935506,2609479
262808547081,750,1,receive,262805955878,2591203
262808547731,326,4,receive,262805960006,2587725
262808572172,246,7,receive,262805928181,2643991
262808572830,518,5,receive,262805940815,2632015
262808573496,504,6,receive,262805997618,2575878
262808574150,332,11,receive,262805991648,2582502
262808574802,296,12,receive,262805964189,2610613
262808617250,270,9,receive,262806014492,2602758
262808617903,308,11,receive,262805935482,2682421
262808618571,264,3,receive,262806000906,2617665
262808619255,192,8,receive,262805996500,2622755
262808619932,426,4,receive,262806043068,2576864
262808654862,776,1,receive,262806067035,2587827
262808655527,796,2,receive,262806080606,2574921
262808656194,544,4,receive,262806089006,2567188
262808670776,650,2,receive,262806110503,2560273
262808693252,416,4,receive,262806110628,2582624
262808693759,522,4,receive,262806106497,2587262
262808694259,554,11,receive,262806108921,2585338
262808694766,216,3,receive,262806137007,2557759
262808695366,282,2,receive,262806127188,2568178
262808696037,242,12,receive,262806140075,2555962
262808696719,524,4,receive,262806163855,2532864
262808745409,642,3,receive,262806168315,2577094
262808746066,756,2,receive,262806149855,2596211
262808766702,656,12,receive,262806183727,2582975
262808767386,270,10,receive,262806141557,2625829
262808780801,430,6,receive,262806222326,2558475
262808785300,548,3,receive,262806249996,2535304
262808795025,502,17,receive,262806205038,2589987
262808795715,798,2,receive,262806265086,2530629
262808796387,302,9,receive,262806245209,2551178
262808806005,396,3,receive,262806290678,2515327
262808808585,180,11,receive,262806289205,2519380
262808812268,426,5,receive,262806235070,2577198
262808817477,242,13,receive,262806285009,2532468
262808824171,728,4,receive,262806246449,2577722
262808824858,310,7,receive,262806393148,2431710
262808828160,456,3,receive,262806338248,2489912
262808831915,410,8,receive,262806429014,2402901
262808875341,566,3,receive,262806421121,2454220
262808876038,784,2,receive,262806388012,2488026
262808876722,770,2,receive,262806424316,2452406
262808877406,284,8,receive,262806396841,2480565
262808878065,694,9,receive,262806390706,2487359
262808878709,696,10,receive,262806446326,2432383
262808912742,530,3,receive,262806469609,2443133
262808913431,412,6,receive,262806486135,2427296
262808914125,676,6,receive,262806461010,2453115
262808914785,340,5,receive,262806471991,2442794
262808915460,346,3,receive,262806491387,2424073
262808993978,546,5,receive,262806487683,2506295
262808994669,408,6,receive,262806488092,2506577
262808995358,296,14,receive,262806552287,2443071
262808996049,550,5,receive,262806549840,2446209
262809010438,800,2,receive,262806547869,2462569
262809016576,200,6,receive,262806552153,2464423
262809021083,710,5,receive,262806562680,2458403
262809027484,342,11,receive,262806542561,2484923
262809034983,602,3,receive,262806607366,2427617
262809039183,334,5,receive,262806613840,2425343
262809048466,746,2,receive,262806603755,2444711
262809052965,284,9,receive,262806611324,2441641
262809063206,386,11,receive,262806618012,2445194
262809071186,194,14,receive,262806634311,2436875
262809077500,530,4,receive,262806648892,2428608
262809099086,750,2,receive,262806638196,2460890
262809099772,662,16,receive,262806695382,2404390
262809100576,474,3,receive,262806646886,2453690
262809101271,694,10,receive,262806723927,2377344
262809112883,300,10,receive,262806692986,2419897
262809119178,360,9,receive,262806737009,2382169
262809119868,190,11,receive,262806733591,2386277
262809131898,598,4,receive,262806747311,2384587
262809139023,522,5,receive,262806756567,2382456
262809151745,616,5,receive,262806750067,2401678
262809152948,584,3,receive,262806779318,2373630
262809159021,642,4,receive,262806786006,2373015
262809164022,282,3,receive,262806779006,2385016
262809164715,516,4,receive,262806782611,2382104
262809185622,728,5,receive,262806777070,2408552
262809186313,492,7,receive,262806832084,2354229
262809186992,484,6,receive,262806838204,2348788
262809187664,690,4,receive,262806814849,2372815
262809217421,460,6,receive,262806850720,2366701
262809218314,190,12,receive,262806855004,2363310
262809219006,260,3,receive,262806885059,2333947
262809219693,566,4,receive,262806874270,2345423
262809235071,308,12,receive,262806894127,2340944
262809243138,312,10,receive,262806900809,2342329
262809243801,574,5,receive,262806935009,2308792
262809244470,554,12,receive,262806893982,2350488
262809245144,424,8,receive,262806910009,2335135
262809268345,368,7,receive,262806914233,2354112
262809269390,130,6,receive,262806922928,2346462
262809274231,510,7,receive,262806972008,2302223
262809286026,272,15,receive,262806951493,2334533
262809286694,430,8,receive,262806961759,2324935
262809302652,448,12,receive,262806977128,2325524
262809303320,602,4,receive,262807041076,2262244
262809303976,656,13,receive,262807050842,2253134
262809304638,300,12,receive,262807087482,2217156
262809305305,530,5,receive,262807082921,2222384
262809305971,266,9,receive,262807101238,2204733
262809336302,672,7,receive,262807066689,2269613
262809336972,548,4,receive,262807101070,2235902
262809337632,214,11,receive,262807092627,2245005
262809355469,328,12,receive,262807077914,2277555
262809373031,270,11,receive,262807078563,2294468
262809373700,242,14,receive,262807085544,2288156
262809377960,498,8,receive,262807107277,2270683
262809383369,312,11,receive,262807097962,2285407
262809387802,456,4,receive,262807044538,2343264
262809404127,4,6,receive,262807138017,2266110
262809404807,326,6,receive,262807082430,2322377
262809405495,322,6,receive,262807124006,2281489
262809406188,204,4,receive,262807163006,2243182
262809406875,492,8,receive,262807137835,2269040
262809443894,416,5,receive,262807105010,2338884
262809444589,304,10,receive,262807194247,2250342
262809445274,524,6,receive,262807192883,2252391
262809445960,452,8,receive,262807194187,2251773
262809446629,192,10,receive,262807225011,2221618
262809473882,292,4,receive,262807185326,2288556
262809474720,334,6,receive,262807255011,2219709
262809482536,696,11,receive,262807283413,2199123
262809490500,486,5,receive,262807281919,2208581
262809512240,250,5,receive,262807265265,2246975
262809512914,294,7,receive,262807269680,2243234
262809513573,518,9,receive,262807269588,2243985
262809518253,386,13,receive,262807310956,2207297
262809524122,396,4,receive,262807310945,2213177
262809540194,572,4,receive,262807295006,2245188
262809540891,264,6,receive,262807285776,2255115
262809548949,204,5,receive,262807365240,2183709
262809555685,328,13,receive,262807357399,2198286
262809556355,190,13,receive,262807364503,2191852
262809574750,180,12,receive,262807346547,2228203
262809575447,550,6,receive,262807351005,2224442
262809581218,784,3,receive,262807341739,2239479
262809589988,598,5,receive,262807371964,2218024
262809593345,650,4,receive,262807406115,2187230
262809605471,616,7,receive,262807394006,2211465
262809606149,242,15,receive,262807414006,2192143
262809606818,254,6,receive,262807438130,2168688
262809607482,728,6,receive,262807442398,2165084
262809608150,322,8,receive,262807464123,2144027
262809608813,478,9,receive,262807440329,2168484
262809638690,528,4,receive,262807475118,2163572
262809643830,266,10,receive,262807470364,2173466
262809648770,696,12,receive,262807505059,2143711
262809655088,748,3,receive,262807491741,2163347
262809669945,240,4,receive,262807500410,2169535
262809670634,784,4,receive,262807490269,2180365
262809671330,272,17,receive,262807524472,2146858
262809672018,770,4,receive,262807532370,2139648
262809692638,310,9,receive,262807561084,2131554
262809693394,506,4,receive,262807557406,2135988
262809699205,504,10,receive,262807562285,2136920
262809705211,798,4,receive,262807562309,2142902
262809712898,546,6,receive,262807536298,2176600
262809727188,648,4,receive,262807538850,2188338
262809727857,4,8,receive,262807593576,2134281
262809728526,800,4,receive,262807576254,2152272
262809729197,330,9,receive,262807616599,2112598
262809742248,462,6,receive,262807596507,2145741
262809754354,426,7,receive,262807630655,2123699
262809755662,468,8,receive,262807634513,2121149
262809761022,342,13,receive,262807633179,2127843
262809769254,624,3,receive,262807626074,2143180
262809775231,296,16,receive,262807609885,2165346
262809783374,516,5,receive,262807660673,2122701
262809786594,270,12,receive,262807661304,2125290
262809793025,336,10,receive,262807680610,2112415
262809799501,196,6,receive,262807709590,2089911
262809805009,302,12,receive,262807693525,2111484
262809817498,292,5,receive,262807730139,2087359
262809818201,644,4,receive,262807746400,2071801
262809818891,522,6,receive,262807721128,2097763
262809832648,412,10,receive,262807760515,2072133
262809833315,694,12,receive,262807755006,2078309
262809833986,416,6,receive,262807751478,2082508
262809849436,340,7,receive,262807779996,2069440
262809854100,256,9,receive,262807793118,2060982
262809860180,286,6,receive,262807792643,2067537
262809860865,190,14,receive,262807798679,2062186
262809880459,282,4,receive,262807802421,2078038
262809881131,478,10,receive,262807830966,2050165
262809881787,642,6,receive,262807833868,2047919
262809882474,294,8,receive,262807844239,2038235
262809893607,326,7,receive,262807829873,2063734
262809908539,602,6,receive,262807828103,2080436
262809909208,546,7,receive,262807850729,2058479
262809909867,300,13,receive,262807861752,2048115
262809924024,296,17,receive,262807859134,2064890
262809924720,130,7,receive,262807882129,2042591
262809940821,400,8,receive,262807902385,2038436
262809941514,676,9,receive,262807914305,2027209
262809945643,650,5,receive,262807935264,2010379
262809951801,458,8,receive,262807938325,2013476
262809970335,338,10,receive,262807931713,2038622
262809971044,528,6,receive,262807936492,2034552
262809972072,268,13,receive,262807940005,2032067
262809976779,748,4,receive,262807961291,2015488
262809985050,504,11,receive,262807929515,2055535
262810003284,524,7,receive,262807959761,2043523
262810003947,474,5,receive,262807978563,2025384
262810004712,180,13,receive,262807993780,2010932
262810007600,264,7,receive,262808008118,1999482
262810016174,310,10,receive,262807979260,2036914
262810027282,318,7,receive,262807971709,2055573
262810027950,514,8,receive,262808021844,2006106
262810028619,200,8,receive,262808019119,2009500
262810029289,370,10,receive,262808039788,1989501
262810029959,518,10,receive,262808030126,1999833
262810030638,306,9,receive,262808054387,1976251
262810057249,644,5,receive,262808044070,2013179
262810057916,270,13,receive,262808034005,2023911
262810058576,456,5,receive,262808060588,1997988
262810059243,214,13,receive,262808134095,1925148
262810059905,334,8,receive,262808125069,1934836
262810082342,550,7,receive,262808122514,1959828
262810085577,386,15,receive,262808165010,1920567
262810090904,272,19,receive,262808153398,1937506
262810097513,410,11,receive,262808167570,1929943
262810109889,426,8,receive,262808131098,1978791
262810110553,408,8,receive,262808142069,1968484
262810115871,746,4,receive,262808184339,1931532
262810121835,576,4,receive,262808146798,1975037
262810127492,504,12,receive,262808185820,1941672
262810143404,284,12,receive,262808157836,1985568
262810144129,648,5,receive,262808191584,1952545
262810144766,446,6,receive,262808180128,1964638
262810145427,302,14,receive,262808205916,1939511
262810146083,530,7,receive,262808236252,1909831
262810146737,798,5,receive,262808197082,1949655
262810182089,292,6,receive,262808198012,1984077
262810182763,512,8,receive,262808240710,1942053
262810183426,286,7,receive,262808243482,1939944
262810197020,694,13,receive,262808288009,1909011
262810214029,430,10,receive,262808289507,1924522
262810214698,196,8,receive,262808296614,1918084
262810215339,626,4,receive,262808273417,1941922
262810215984,728,7,receive,262808276185,1939799
262810216629,322,10,receive,262808309125,1907504
262810217281,308,15,receive,262808292463,1924818
262810217934,602,7,receive,262808307707,1910227
262810249622,266,11,receive,262808326193,1923429
262810258023,458,9,receive,262808318642,1939381
262810266024,784,6,receive,262808353913,1912111
262810266681,426,9,receive,262808340009,1926672
262810267332,242,16,receive,262808357398,1909934
262810267979,598,6,receive,262808368821,1899158
262810301959,650,6,receive,262808359522,1942437
262810302630,690,7,receive,262808376138,1926492
262810303310,446,7,receive,262808398373,1904937
262810303976,570,6,receive,262808378757,1925219
262810304637,286,8,receive,262808426549,1878088
262810328275,190,15,receive,262808426476,1901799
262810328947,4,9,receive,262808394510,1934437
262810329561,616,8,receive,262808454190,1875371
262810330213,518,11,receive,262808457148,1873065
262810330865,710,7,receive,262808421008,1909857
262810359226,408,9,receive,262808472405,1886821
262810359873,486,7,receive,262808484378,1875495
262810360524,200,9,receive,262808565005,1795519
262810361173,338,11,receive,262808554009,1807164
262810361820,260,6,receive,262808573010,1788810
262810397234,330,10,receive,262808588353,1808881
262810397877,440,6,receive,262808575158,1822719
262810398533,268,15,receive,262808564766,1833767
262810399187,624,5,receive,262808582133,1817054
262810399839,468,10,receive,262808557972,1841867
262810427180,756,5,receive,262808551881,1875299
262810427826,572,6,receive,262808604348,1823478
262810428580,396,7,receive,262808611640,1816940
262810429236,130,8,receive,262808604943,1824293
262810429883,530,8,receive,262808631005,1798878
262810452028,602,8,receive,262808620135,1831893
262810452681,412,11,receive,262808624734,1827947
262810453322,370,12,receive,262808602205,1851117
262810453899,448,14,receive,262808625410,1828489
262810454543,368,10,receive,262808644617,1809926
262810484407,478,11,receive,262808655430,1828977
262810485019,460,9,receive,262808652946,1832073
262810485670,336,12,receive,262808665497,1820173
262810486325,544,8,receive,262808682123,1804202
262810486975,342,14,receive,262808680698,1806277
262810487620,416,8,receive,262808697626,1789994
262810522041,522,9,receive,262808679420,1842621
262810522694,266,12,receive,262808708854,1813840
262810523366,256,11,receive,262808694207,1829159
262810524009,430,11,receive,262808706528,1817481
262810530461,302,15,receive,262808695008,1835453
262810548813,410,13,receive,262808730118,1818695
262810549466,728,8,receive,262808741722,1807744
262810550122,296,18,receive,262808697195,1852927
262810551879,294,10,receive,262808764785,1787094
262810557170,548,6,receive,262808759141,1798029
262810565475,338,12,receive,262808763855,1801620
262810570115,676,10,receive,262808745507,1824608
262810570889,216,6,receive,262808797705,1773184
262810575852,546,8,receive,262808825416,1750436
262810580889,550,8,receive,262808799361,1781528
262810590013,576,5,receive,262808803858,1786155
262810593279,446,8,receive,262808795384,1797895
262810596056,240,7,receive,262808826005,1770051
262810602460,644,7,receive,262808827419,1775041
262810606028,574,8,receive,262808859010,1747018
262810614420,650,7,receive,262808824619,1789801
262810618719,474,7,receive,262808789355,1829364
262810620744,642,8,receive,262808867535,1753209
262810628229,748,5,receive,262808881008,1747221
262810631164,548,7,receive,262808888918,1742246
262810639149,648,6,receive,262808894118,1745031
262810640559,514,9,receive,262808878654,1761905
262810647459,672,10,receive,262808874395,1773064
262810652350,460,10,receive,262808899880,1752470
262810655745,292,7,receive,262808920630,1735115
262810664281,692,8,receive,262808891012,1773269
262810668444,448,15,receive,262808921873,1746571
262810670567,200,10,receive,262808927129,1743438
262810676062,798,6,receive,262808998087,1677975
262810681574,650,8,receive,262808993104,1688470
262810694453,400,10,receive,262808993095,1701358
262810695108,764,6,receive,262808979956,1715152
262810695764,570,7,receive,262809006007,1689757
262810696416,690,8,receive,262809000247,1696169
262810697054,696,14,receive,262809001095,1695959
262810697705,750,7,receive,262809006137,1691568
262810720532,516,7,receive,262808993930,1726602
262810721184,204,8,receive,262808995435,1725749
262810725307,624,6,receive,262809034237,1691070
262810728530,340,9,receive,262809070078,1658452
262810735033,492,10,receive,262809055006,1680027
262810745555,216,7,receive,262809079516,1666039
262810746211,270,15,receive,262809051423,1694788
262810746857,572,7,receive,262809049013,1697844
262810747511,664,9,receive,262809087062,1660449
262810748162,370,13,receive,262809109952,1638210
262810748816,616,9,receive,262809113144,1635672
262810773896,544,9,receive,262809133547,1640349
262810774549,268,16,receive,262809130240,1644309
262810775161,458,10,receive,262809130011,1645150
262810786849,528,8,receive,262809146348,1640501
262810796736,746,6,receive,262809148010,1648726
262810797398,626,5,receive,262809134929,1662469
262810798055,504,14,receive,262809126339,1671716
262810798707,282,7,receive,262809166202,1632505
262810799366,250,7,receive,262809179269,1620097
262810823244,566,8,receive,262809185230,1638014
262810823902,512,9,receive,262809166451,1657451
262810824550,318,9,receive,262809172006,1652544
262810825208,642,9,receive,262809195971,1629237
262810825772,710,8,receive,262809189832,1635940
262810844021,4,10,receive,262809185684,1658337
262810844715,292,8,receive,262809206875,1637840
262810851448,346,7,receive,262809175191,1676257
262810853131,756,6,receive,262809223532,1629599
262810858629,572,8,receive,262809244203,1614426
262810863458,350,9,receive,262809237599,1625859
262810873125,256,12,receive,262809238027,1635098
262810873745,750,8,receive,262809263119,1610626
262810874391,784,7,receive,262809258230,1616161
262810875046,408,10,receive,262809275530,1599516
262810897828,486,8,receive,262809275326,1622502
262810898483,284,14,receive,262809247484,1650999
262810899142,196,9,receive,262809243190,1655952
262810899783,764,7,receive,262809271528,1628255
262810900445,518,12,receive,262809288121,1612324
262810925857,530,9,receive,262809320649,1605208
262810926538,304,14,receive,262809315346,1611192
262810927196,410,15,receive,262809319228,1607968
262810927845,516,8,receive,262809295010,1632835
262810928504,566,9,receive,262809329415,1599089
262810945417,770,7,receive,262809337283,1608134
262810946072,498,11,receive,262809359481,1586591
262810951030,692,9,receive,262809357135,1593895
262810951744,240,8,receive,262809362972,1588772
262810955950,286,9,receive,262809382007,1573943
262810965184,334,11,receive,262809358498,1606686
262810967999,266,13,receive,262809360007,1607992
262810969413,506,8,receive,262809392006,1577407
262810976761,676,11,receive,262809393469,1583292
262810978022,642,10,receive,262809407855,1570167
262810992069,648,7,receive,262809385689,1606380
262810992724,800,8,receive,262809390754,1601970
262810993379,130,9,receive,262809411563,1581816
262810994034,462,8,receive,262809410205,1583829
262810994689,310,12,receive,262809426708,1567981
262811011180,516,9,receive,262809443004,1568176
262811011829,368,11,receive,262809438117,1573712
262811012485,602,9,receive,262809453706,1558779
262811013135,254,9,receive,262809459062,1554073
262811013778,710,9,receive,262809437420,1576358
262811029054,572,9,receive,262809463115,1565939
262811029665,776,6,receive,262809462593,1567072
262811030322,440,7,receive,262809450834,1579488
262811030960,616,10,receive,262809488450,1542510
262811031612,510,11,receive,262809525541,1506071
262811056180,416,9,receive,262809508872,1547308
262811056800,808,8,receive,262809532009,1524791
262811057569,770,8,receive,262809549299,1508270
262811058221,598,8,receive,262809526942,1531279
262811058868,302,16,receive,262809554098,1504770
262811059519,282,8,receive,262809533797,1525722
262811078693,644,9,receive,262809543404,1535289
262811079350,570,8,receive,262809572704,1506646
262811080002,342,16,receive,262809576292,1503710
262811084250,446,9,receive,262809581007,1503243
262811087658,264,10,receive,262809575575,1512083
262811097359,522,10,receive,262809589637,1507722
262811099541,408,11,receive,262809596285,1503256
262811100254,796,8,receive,262809605420,1494834
262811104959,326,9,receive,262809610976,1493983
262811111272,412,12,receive,262809617369,1493903
262811120693,546,9,receive,262809626182,1494511
262811122072,492,11,receive,262809624253,1497819
262811122725,254,10,receive,262809619807,1502918
262811123377,566,10,receive,262809638006,1485371
262811124022,350,10,receive,262809636010,1488012
262811124655,330,12,receive,262809653377,1471278
262811138417,650,9,receive,262809658139,1480278
262811139099,410,17,receive,262809663673,1475426
262811139777,304,15,receive,262809678005,1461772
262811140450,468,12,receive,262809664290,1476160
262811141115,576,6,receive,262809673219,1467896
262811161051,338,13,receive,262809690183,1470868
262811161862,798,7,receive,262809697021,1464841
262811166608,346,8,receive,262809709865,1456743
262811171160,746,7,receive,262809707569,1463591
262811183445,270,16,receive,262809708372,1475073
262811184126,284,15,receive,262809722132,1461994
262811184783,728,9,receive,262809726369,1458414
262811185439,524,9,receive,262809717422,1468017
262811186137,456,7,receive,262809737595,1448542
262811186817,368,12,receive,262809703005,1483812
262811207019,310,13,receive,262809752596,1454423
262811207732,626,6,receive,262809733702,1474030
262811211930,572,10,receive,262809762116,1449814
262811215221,624,7,receive,262809750012,1465209
262811225095,200,11,receive,262809746635,1478460
262811225819,314,10,receive,262809759793,1466026
262811232030,528,9,receive,262809793957,1438073
262811232774,318,10,receive,262809781840,1450934
262811238024,770,9,receive,262809792229,1445795
262811245281,546,10,receive,262809805709,1439572
262811245999,250,9,receive,262809796411,1449588
262811250770,690,9,receive,262809815071,1435699
262811253986,196,10,receive,262809823743,1430243
262811258270,460,11,receive,262809822006,1436264
262811266161,204,9,receive,262809810367,1455794
262811266898,240,10,receive,262809806293,1460605
262811269738,458,11,receive,262809852756,1416982
262811273355,498,12,receive,262809830686,1442669
262811279318,800,9,receive,262809854362,1424956
262811285017,576,7,receive,262809858125,1426892
262811285705,710,10,receive,262809886987,1398718
262811286378,514,10,receive,262809860336,1426042
262811287064,548,8,receive,262809904477,1382587
262811287745,254,11,receive,262809914495,1373250
262811303658,584,8,receive,262809931834,1371824
262811304380,650,10,receive,262809925765,1378615
262811305061,570,9,receive,262809936012,1369049
262811305716,400,11,receive,262809952007,1353709
262811306384,808,9,receive,262809953390,1352994
262811321555,478,13,receive,262809952204,1369351
262811322250,784,8,receive,262809942792,1379458
262811322941,572,11,receive,262809961443,1361498
262811323617,644,10,receive,262809996101,1327516
262811324286,574,10,receive,262810001616,1322670
262811338341,346,9,receive,262810007902,1330439
262811339029,462,10,receive,262810007006,1332023
262811339711,504,15,receive,262810038007,1301704
262811340394,284,16,receive,262810053309,1287085
262811341061,216,8,receive,262810035181,1305880
262811341711,524,10,receive,262810053308,1288403
262811359825,510,12,receive,262810059298,1300527
262811361609,664,10,receive,262810060613,1300996
262811365467,408,12,receive,262810061293,1304174
262811366154,598,9,receive,262810064007,1302147
262811366825,692,10,receive,262810071758,1295067
262811377686,544,10,receive,262810077705,1299981
262811380991,690,10,receive,262810070897,1310094
262811384849,566,12,receive,262810076473,1308376
262811389528,254,12,receive,262810084859,1304669
262811393942,584,9,receive,262810091626,1302316
262811394624,396,10,receive,262810058432,1336192
262811400755,784,9,receive,262810078049,1322706
262811404402,302,17,receive,262810092967,1311435
262811407368,516,10,receive,262810100640,1306728
262811415751,204,10,receive,262810117824,1297927
262811416437,770,10,receive,262810124943,1291494
262811417157,440,8,receive,262810131888,1285269
262811417845,564,7,receive,262810142071,1275774
262811418533,800,10,receive,262810116450,1302083
262811435415,260,8,receive,262810144136,1291279
262811436097,292,10,receive,262810147012,1289085
262811436779,412,13,receive,262810154953,1281826
262811444786,458,12,receive,262810106541,1338245
262811449490,294,12,receive,262810149908,1299582
262811450793,426,12,receive,262810179468,1271325
262811453522,196,11,receive,262810171953,1281569
262811458023,504,16,receive,262810183848,1274175
262811461945,550,10,receive,262810166836,1295109
262811466906,342,17,receive,262810196131,1270775
262811467689,282,10,receive,262810191515,1276174
262811470793,286,10,receive,262810214559,1256234
262811474806,748,7,receive,262810210190,1264616
262811477956,676,12,receive,262810222431,1255525
262811482042,756,7,receive,262810224759,1257283
262811485537,784,10,receive,262810219007,1266530
262811492021,410,18,receive,262810221006,1271015
262811492879,548,9,receive,262810212231,1280648
262811494321,506,9,receive,262810233670,1260651
262811500985,130,10,receive,262810227955,1273030
262811501673,304,16,receive,262810238304,1263369
262811502365,408,13,receive,262810224426,1277939
262811503050,460,12,receive,262810241260,1261790
262811503731,216,9,receive,262810247128,1256603
262811516296,484,10,receive,262810244455,1271841
262811516957,310,14,receive,262810269011,1247946
262811517621,486,9,receive,262810251332,1266289
262811518286,492,12,receive,262810279063,1239223
262811529417,416,10,receive,262810306006,1223411
262811533701,292,11,receive,262810321647,1212054
262811536447,254,13,receive,262810347007,1189440
262811538767,314,11,receive,262810352201,1186566
262811541751,410,19,receive,262810350769,1190982
262811548359,458,13,receive,262810352329,1196030
262811550603,624,8,receive,262810352241,1198362
262811553548,648,8,receive,262810366131,1187417
262811555715,310,15,receive,262810381010,1174705
262811559021,334,12,receive,262810379773,1179248
262811563662,750,10,receive,262810397006,1166656
262811565850,318,11,receive,262810407119,1158731
262811568771,800,11,receive,262810412005,1156766
262811570876,574,11,receive,262810415014,1155862
262811573390,396,11,receive,262810422723,1150667
262811576335,342,18,receive,262810421537,1154798
262811580033,544,11,receive,262810414397,1165636
262811584519,570,10,receive,262810435555,1148964
262811585196,200,12,receive,262810445578,1139618
262811585857,474,10,receive,262810428839,1157018
262811596340,650,12,receive,262810452957,1143383
262811599553,784,11,receive,262810458682,1140871
262811603103,426,13,receive,262810475475,1127628
262811603755,264,11,receive,262810482516,1121239
262811612138,286,11,receive,262810484338,1127800
262811618202,510,13,receive,262810483138,1135064
262811619913,676,13,receive,262810485643,1134270
262811622189,626,7,receive,262810461793,1160396
262811624492,522,11,receive,262810465128,1159364
262811625156,4,12,receive,262810489537,1135619
262811625817,672,12,receive,262810480210,1145607
262811636724,130,11,receive,262810488618,1148106
262811637386,796,9,receive,262810484302,1153084
262811638048,624,9,receive,262810495260,1142788
262811638733,644,11,receive,262810506420,1132313
262811639422,498,13,receive,262810501064,1138358
262811652536,440,9,receive,262810524275,1128261
262811653226,690,11,receive,262810545785,1107441
262811654057,798,8,receive,262810527658,1126399
262811654773,350,11,receive,262810557964,1096809
262811659022,412,14,receive,262810571558,1087464
262811666420,292,12,receive,262810574717,1091703
262811667100,304,17,receive,262810584632,1082468
262811667758,200,13,receive,262810591696,1076062
262811668413,468,13,receive,262810607005,1061408
262811669078,400,12,receive,262810604840,1064238
262811669735,764,9,receive,262810582432,1087303
262811684390,492,13,receive,262810615306,1069084
262811685054,564,8,receive,262810647189,1037865
262811685712,572,12,receive,262810633005,1052707
262811686372,808,10,receive,262810663006,1023366
262811697043,710,11,receive,262810663981,1033062
262811697709,800,12,receive,262810682004,1015705
262811698371,746,8,receive,262810667513,1030858
262811699034,648,9,receive,262810698567,1000467
262811699688,250,10,receive,262810693926,1005762
262811700352,544,12,receive,262810715011,985341
262811721596,576,8,receive,262810722556,999040
262811722271,750,11,receive,262810728476,993795
262811722934,522,12,receive,262810692906,1030028
262811723602,342,19,receive,262810737005,986597
262811724246,546,11,receive,262810751723,972523
262811737244,286,12,receive,262810752768,984476
262811737902,462,11,receive,262810744666,993236
262811738567,644,12,receive,262810754588,983979
262811739235,510,14,receive,262810736601,1002634
262811739900,412,15,receive,262810772905,966995
262811740563,240,11,receive,262810746952,993611
262811755431,776,8,receive,262810794896,960535
262811756098,770,11,receive,262810810469,945629
262811762268,550,11,receive,262810847762,914506
262811762983,492,14,receive,262810857127,905856
262811767172,314,12,receive,262810864606,902566
262811771046,204,11,receive,262810873283,897763
262811771714,548,10,receive,262810865978,905736
262811772369,728,11,receive,262810875010,897359
262811773032,644,13,receive,262810875700,897332
262811773691,764,10,receive,262810873454,900237
262811774349,498,14,receive,262810884938,889411
262811789254,346,10,receive,262810902810,886444
262811791886,572,13,receive,262810914648,877238
262811794051,748,8,receive,262810935330,858721
262811796023,664,11,receive,262810922337,873686
262811799137,746,9,receive,262810944965,854172
262811800588,756,8,receive,262810941017,859571
262811802745,514,12,receive,262810948729,854016
262811804754,650,13,receive,262810973758,830996
262811807020,784,12,receive,262810971176,835844
262811809978,410,20,receive,262810988530,821448
262811811427,294,13,receive,262810991186,820241
262811819417,282,11,receive,262810999826,819591
262811824399,546,12,receive,262811005686,818713
262811826572,260,9,receive,262810993079,833493
262811828020,416,11,receive,262811012385,815635
262811830095,486,10,receive,262811005065,825030
262811832375,644,14,receive,262811005169,827206
262811834539,342,20,receive,262811017729,816810
262811836731,566,13,receive,262811020905,815826
262811838936,440,10,receive,262811042006,796930
262811841164,302,18,receive,262811052010,789154
262811843332,570,11,receive,262811060195,783137
262811845505,692,11,receive,262811046061,799444
262811848961,776,9,receive,262811073571,775390
262811851019,492,15,receive,262811056803,794216
262811852800,484,11,receive,262811079005,773795
262811857280,264,12,receive,262811034567,822713
262811862021,240,12,receive,262811110172,751849
262811864254,318,12,receive,262811119009,745245
262811865078,196,12,receive,262811120779,744299
262811868615,710,12,receive,262811087067,781548
262811873021,304,18,receive,262811147241,725780
262811873737,626,8,receive,262811151339,722398
262811875807,310,16,receive,262811150748,725059
262811876530,408,14,receive,262811157611,718919
262811878440,576,9,receive,262811152308,726132
262811883022,4,13,receive,262811170469,712553
262811883690,396,12,receive,262811170040,713650
262811886441,650,14,receive,262811183685,702756
262811887158,570,12,receive,262811190919,696239
262811889759,796,10,receive,262811189348,700411
262811895021,292,13,receive,262811194548,700473
262811898552,572,14,receive,262811185170,713382
262811899276,462,12,receive,262811209988,689288
262811899997,440,11,receive,262811214694,685303
262811904021,516,12,receive,262811207124,696897
262811904683,746,10,receive,262811223727,680956
262811905344,216,10,receive,262811233646,671698
262811909906,546,13,receive,262811254401,655505
262811910630,474,11,receive,262811246354,664276
262811913088,334,13,receive,262811250060,663028
262811914525,648,10,receive,262811259551,654974
262811915969,544,13,receive,262811272841,643128
262811917021,458,14,receive,262811271633,645388
262811918662,330,14,receive,262811280075,638587
262811922783,342,21,receive,262811283062,639721
262811924866,798,9,receive,262811292742,632124
262811925581,574,12,receive,262811301459,624122
262811926356,284,18,receive,262811299776,626580
262811927131,510,15,receive,262811297622,629509
262811927905,676,14,receive,262811341045,586860
262811928748,492,16,receive,262811334612,594136
262811929526,416,12,receive,262811337525,592001
262811930292,240,13,receive,262811336539,593753
262811931008,292,14,receive,262811355887,575121
262811931723,204,12,receive,262811359556,572167
262811932439,462,13,receive,262811366987,565452
262811933156,576,10,receive,262811397475,535681
262811933869,624,10,receive,262811407964,525905
262811934585,396,13,receive,262811396294,538291
262811935293,400,13,receive,262811412861,522432
262811936047,672,13,receive,262811420026,516021
262811936761,318,13,receive,262811437125,499636
262811937540,808,11,receive,262811448343,489197
262811938267,644,15,receive,262811455418,482849
262811938990,440,12,receive,262811455394,483596
262811939705,294,14,receive,262811466791,472914
262811940439,314,13,receive,262811472502,467937
262811941165,626,9,receive,262811479539,461626
262811941873,302,19,receive,262811489886,451987
262811942582,544,14,receive,262811504010,438572
262811943296,130,12,receive,262811506482,436814
262811944016,800,13,receive,262811514582,429434
262811944730,548,11,receive,262811522006,422724
262811945438,486,11,receive,262811526388,419050
262811946159,468,14,receive,262811527672,418487
262811946876,746,11,receive,262811541882,404994
262811954371,510,16,receive,262811527010,427361
262811955086,484,12,receive,262811577696,377390
262811955770,748,9,receive,262811591564,364206
262811956429,676,15,receive,262811592004,364425
262811957091,260,10,receive,262811599320,357771
262811957748,574,13,receive,262811601133,356615
262811958413,570,13,receive,262811602730,355683
262811959085,784,13,receive,262811599006,360079
262811959617,286,13,receive,262811622719,336898
262811959968,294,15,receive,262811625895,334073
262811960326,240,14,receive,262811633316,327010
262811960743,798,10,receive,262811663503,297240
262811961113,204,13,receive,262811669179,291934
262811961458,710,13,receive,262811703008,258450
262811961800,522,13,receive,262811702918,258882
262811962173,514,13,receive,262811698773,263400
262811962520,410,21,receive,262811710627,251893
262811962864,302,20,receive,262811714067,248797
262811963205,400,14,receive,262811735266,227939
262811963584,216,11,receive,262811754492,209092
262811963928,468,15,receive,262811774684,189244
262811967384,550,12,receive,262811772117,195267
262811968085,748,10,receive,262811812577,155508
262811968667,570,14,receive,262811814308,154359
262811969316,458,15,receive,262811812120,157196
262811969960,294,16,receive,262811817038,152922
262811972714,474,12,receive,262811852981,119733
262811973172,486,12,receive,262811850005,123167
262811973830,784,14,receive,262811854334,119496
262811974303,522,14,receive,262811864495,109808
262811974679,550,13,receive,262811887950,86729
262811975056,334,14,receive,262811890870,84186
262811975424,240,15,receive,262811918005,57419
262811975802,264,13,receive,262811947011,28791
262811976190,292,15,receive,262811950592,25598
262811976564,626,10,receive,262811963897,12667
262811976932,284,19,receive,262811966386,10546
262811989993,516,13,receive,262811980133,9860
262811991474,400,15,receive,262811982844,8630
262811991909,796,11,receive,262811987268,4641
262812015675,566,14,receive,262812012652,3023
262812018962,492,17,receive,262812017079,1883
262812021390,216,12,receive,262812019999,1391
262812036305,576,11,receive,262812033427,2878
262812040309,458,16,receive,262812038454,1855
262812043456,748,11,receive,262812042518,938
262812055488,624,11,receive,262812054749,739
262812065057,462,14,receive,262812062510,2547
262812072076,486,13,receive,262812071461,615
262812093997,776,10,receive,262812091475,2522
262812094492,546,14,receive,262812093640,852
262812101337,676,16,receive,262812098924,2413
262812102608,572,15,receive,262812102022,586
262812121343,260,11,receive,262812120005,1338
262812125252,4,14,receive,262812122348,2904
262812151570,648,11,receive,262812149018,2552
262812174960,484,13,receive,262812173059,1901
262812180927,784,15,receive,262812179889,1038
262812183680,240,16,receive,262812182148,1532
262812186436,548,12,receive,262812184204,2232
262812189180,574,14,receive,262812188608,572
262812196384,550,14,receive,262812194094,2290
262812209473,672,14,receive,262812208822,651
262812232529,216,13,receive,262812231277,1252
262812235900,400,16,receive,262812234251,1649
262812252665,462,15,receive,262812250692,1973
262812253240,4,15,receive,262812250985,2255
262812270098,572,16,receive,262812267888,2210
262812279999,796,12,receive,262812278511,1488
262812285158,798,11,receive,262812283474,1684
262812301795,784,16,receive,262812299616,2179
262812310799,776,11,receive,262812309262,1537
262812311197,318,14,receive,262812310266,931
262812316668,314,14,receive,262812314848,1820
262812321261,644,16,receive,262812320086,1175
262812327409,458,17,receive,262812325288,2121
262812333856,748,12,receive,262812333445,411
262812352111,334,15,receive,262812348084,4027
262812377151,294,17,receive,262812376380,771
262812379770,474,13,receive,262812379468,302
262812398228,486,14,receive,262812397660,568
262812404190,130,13,receive,262812400698,3492
262812414414,808,12,receive,262812413957,457
262812419202,400,17,receive,262812417620,1582
262812434509,574,15,receive,262812431307,3202
262812436608,260,12,receive,262812435642,966
262812455717,626,11,receive,262812452982,2735
262812490530,544,15,receive,262812489885,645
262812495990,572,17,receive,262812494417,1573
262812498273,648,12,receive,262812497883,390
262812528089,204,14,receive,262812525887,2202
262812534742,570,15,receive,262812534172,570
262812539666,294,18,receive,262812537580,2086
262812547521,746,12,receive,262812546502,1019
262812568877,302,21,receive,262812567190,1687
262812579707,4,16,receive,262812578248,1459
262812583381,458,18,receive,262812580099,3282
262812638404,576,12,receive,262812636289,2115
262812640394,672,15,receive,262812639193,1201
262812668717,550,15,receive,262812665323,3394
262812669274,710,14,receive,262812665309,3965
262812671589,216,14,receive,262812669391,2198
262812675059,784,17,receive,262812671625,3434
262812675606,334,16,receive,262812672868,2738
262812679164,548,13,receive,262812678797,367
262812718198,522,15,receive,262812714631,3567
262812718561,468,16,receive,262812716437,2124
262812737726,462,16,receive,262812736275,1451
262812761964,648,13,receive,262812759721,2243
262812798269,576,13,receive,262812796712,1557
262812809905,626,12,receive,262812808477,1428
262812905091,676,17,receive,262812903446,1645
262812917915,468,17,receive,262812916498,1417
262812925947,776,12,receive,262812924603,1344
262812944174,400,18,receive,262812938438,5736
262812944681,566,15,receive,262812941280,3401
262813019929,624,12,receive,262813018637,1292
262813077033,796,13,receive,262813076011,1022
262813100756,710,15,receive,262813099578,1178
262813149645,748,13,receive,262813148313,1332
262813171869,474,14,receive,262813170961,908
262813183225,648,14,receive,262813181590,1635
262813214285,784,18,receive,262813213068,1217
262813217539,624,13,receive,262813216290,1249
262813220392,314,15,receive,262813220067,325
262813222969,570,16,receive,262813221789,1180
262813253717,672,16,receive,262813253196,521
262813254798,318,15,receive,262813254311,487
262813274953,462,17,receive,262813274073,880
262813351175,334,17,receive,262813349710,1465
262813380404,808,13,receive,262813378675,1729
