receive_timestamp,source_vehicle,message_id,event_type,send_timestamp,latency_us
263175056182,22,1,receive,263175050579,5603
263175056664,52,1,receive,263175050781,5883
263175057095,60,1,receive,263175050986,6109
263175057521,12,1,receive,263175051570,5951
263175066166,28,1,receive,263175051587,14579
263175066455,34,1,receive,263175051763,14692
263175066742,46,1,receive,263175052225,14517
263175067032,6,1,receive,263175052385,14647
263175067321,2,1,receive,263175052662,14659
263175067612,24,1,receive,263175053054,14558
263175067909,56,1,receive,263175053710,14199
263175083125,72,1,receive,263175053855,29270
263175083592,38,1,receive,263175054067,29525
263175088419,84,1,receive,263175054116,34303
263175088895,70,1,receive,263175054264,34631
263175089379,66,1,receive,263175054271,35108
263175089857,54,1,receive,263175054829,35028
263175102858,76,1,receive,263175055165,47693
263175103292,18,1,receive,263175055370,47922
263175103667,92,1,receive,263175055669,47998
263175104097,80,1,receive,263175056356,47741
263175104594,58,1,receive,263175057275,47319
263175105038,16,1,receive,263175057612,47426
263175105534,82,1,receive,263175057653,47881
263175106027,48,1,receive,263175058339,47688
263175106448,32,1,receive,263175058610,47838
263175106848,94,1,receive,263175058884,47964
263175107310,64,1,receive,263175059143,48167
263175107782,86,1,receive,263175059382,48400
263175108199,90,1,receive,263175059780,48419
263175108622,98,1,receive,263175059969,48653
263175109127,30,1,receive,263175060456,48671
263175109628,62,1,receive,263175061695,47933
263175110132,100,1,receive,263175062184,47948
263175110633,78,1,receive,263175063139,47494
263175111136,40,1,receive,263175067835,43301
263175111642,96,1,receive,263175070602,41040
263175112145,68,1,receive,263175072387,39758
263175112650,44,1,receive,263175072851,39799
263175113156,74,1,receive,263175074204,38952
263175113656,88,1,receive,263175083777,29879
263175156346,22,2,receive,263175154571,1775
263175165592,14,2,receive,263175164365,1227
263175166450,98,2,receive,263175166048,402
263175169073,90,2,receive,263175168631,442
263175170455,82,2,receive,263175170026,429
263175172530,4,2,receive,263175172017,513
263175178483,38,2,receive,263175177925,558
263175181179,12,2,receive,263175179539,1640
263175184866,60,2,receive,263175183337,1529
263175189588,84,2,receive,263175188848,740
263175194986,28,2,receive,263175191536,3450
263175195397,80,2,receive,263175192562,2835
263175195766,58,2,receive,263175192770,2996
263175196135,16,2,receive,263175194622,1513
263175196496,96,2,receive,263175195103,1393
263175210780,54,2,receive,263175196688,14092
263175213318,70,2,receive,263175197127,16191
263175213663,88,2,receive,263175198781,14882
263175214019,100,2,receive,263175200326,13693
263175214388,42,2,receive,263175201560,12828
263175214765,6,2,receive,263175201636,13129
263175221593,56,2,receive,263175204288,17305
263175221999,72,2,receive,263175205381,16618
263175222378,64,2,receive,263175211008,11370
263175222747,32,2,receive,263175211937,10810
263175223885,86,2,receive,263175214664,9221
263175224252,26,2,receive,263175216941,7311
263175224620,92,2,receive,263175217004,7616
263175225980,30,2,receive,263175217596,8384
263175226342,8,2,receive,263175217571,8771
263175226694,44,2,receive,263175224575,2119
263175241650,76,2,receive,263175236710,4940
263175242055,50,2,receive,263175239540,2515
263175245546,10,2,receive,263175243124,2422
263175246691,36,2,receive,263175244138,2553
263175247086,24,2,receive,263175245707,1379
263175253199,40,2,receive,263175248344,4855
263175254300,20,2,receive,263175249205,5095
263175254680,78,2,receive,263175249656,5024
263175255081,68,2,receive,263175253255,1826
263175255473,48,2,receive,263175253247,2226
263175268457,34,2,receive,263175256535,11922
263175269190,18,2,receive,263175262593,6597
263175269591,66,2,receive,263175263023,6568
263175269982,94,2,receive,263175264263,5719
263175270379,2,2,receive,263175266108,4271
263175270770,62,2,receive,263175267094,3676
263175280764,52,2,receive,263175273578,7186
263175281157,46,2,receive,263175274391,6766
263175283514,74,2,receive,263175282470,1044
263175284929,90,3,receive,263175283566,1363
263175296555,12,3,receive,263175295528,1027
263175301589,22,3,receive,263175300182,1407
263175321448,100,3,receive,263175317261,4187
263175321841,42,3,receive,263175317279,4562
263175327392,26,3,receive,263175326504,888
263175332208,58,3,receive,263175329943,2265
263175333935,96,3,receive,263175332388,1547
263175334663,86,3,receive,263175333518,1145
263175335089,28,3,receive,263175332477,2612
263175339477,70,3,receive,263175335634,3843
263175344845,72,3,receive,263175343887,958
263175346316,6,3,receive,263175344283,2033
263175351743,32,3,receive,263175349364,2379
263175352129,98,3,receive,263175350666,1463
263175360439,56,3,receive,263175352974,7465
263175360821,54,3,receive,263175353890,6931
263175361231,82,3,receive,263175353967,7264
263175361633,76,3,receive,263175355820,5813
263175362034,16,3,receive,263175359393,2641
263175365171,14,3,receive,263175362698,2473
263175370341,78,3,receive,263175367967,2374
263175375459,24,3,receive,263175374828,631
263175377314,4,3,receive,263175375315,1999
263175379932,18,3,receive,263175377422,2510
263175382169,88,3,receive,263175379862,2307
263175384944,40,3,receive,263175384012,932
263175387972,60,3,receive,263175386707,1265
263175389384,48,3,receive,263175388134,1250
263175393511,84,3,receive,263175389473,4038
263175399384,94,3,receive,263175391119,8265
263175399778,68,3,receive,263175393575,6203
263175400201,38,3,receive,263175395192,5009
263175400614,30,3,receive,263175395692,4922
263175410422,46,3,receive,263175402447,7975
263175410839,74,3,receive,263175405778,5061
263175411268,80,3,receive,263175409214,2054
263175415008,8,3,receive,263175412065,2943
263175418013,66,3,receive,263175416425,1588
263175421654,50,3,receive,263175420467,1187
263175424734,64,3,receive,263175422287,2447
263175430172,92,3,receive,263175428446,1726
263175430822,100,4,receive,263175428600,2222
263175439894,34,3,receive,263175430122,9772
263175440330,52,3,receive,263175433716,6614
263175440758,10,3,receive,263175433778,6980
263175441194,44,3,receive,263175434347,6847
263175441615,36,3,receive,263175434515,7100
263175448880,20,3,receive,263175439497,9383
263175451751,12,4,receive,263175450129,1622
263175453853,2,3,receive,263175452696,1157
263175457246,26,4,receive,263175453876,3370
263175461258,98,4,receive,263175459214,2044
263175470718,62,3,receive,263175468978,1740
263175476823,90,4,receive,263175474904,1919
263175479045,28,4,receive,263175477800,1245
263175482324,96,4,receive,263175480327,1997
263175490543,16,4,receive,263175489029,1514
263175497676,82,4,receive,263175496861,815
263175509933,6,4,receive,263175504008,5925
263175510365,88,4,receive,263175504027,6338
263175512459,76,4,receive,263175510477,1982
263175523464,32,4,receive,263175512989,10475
263175523891,72,4,receive,263175514470,9421
263175524326,22,4,receive,263175514591,9735
263175524743,86,4,receive,263175515173,9570
263175525181,70,4,receive,263175515271,9910
263175537455,54,4,receive,263175517810,19645
263175537876,74,4,receive,263175518568,19308
263175538315,46,4,receive,263175525682,12633
263175538737,42,4,receive,263175527631,11106
263175544322,68,4,receive,263175533028,11294
263175544760,34,4,receive,263175538969,5791
263175545220,24,4,receive,263175542064,3156
263175558096,4,4,receive,263175545881,12215
263175558508,18,4,receive,263175546319,12189
263175558921,58,4,receive,263175544208,14713
263175559346,92,4,receive,263175548347,10999
263175559755,78,4,receive,263175552124,7631
263175560171,48,4,receive,263175551248,8923
263175574064,38,4,receive,263175561271,12793
263175574521,56,4,receive,263175568253,6268
263175575127,14,4,receive,263175569558,5569
263175575559,62,4,receive,263175574613,946
263175591340,84,4,receive,263175584124,7216
263175591985,100,5,receive,263175585624,6361
263175593552,40,4,receive,263175585753,7799
263175593962,66,4,receive,263175588187,5775
263175594390,36,4,receive,263175588643,5747
263175594798,60,4,receive,263175590230,4568
263175595213,50,4,receive,263175591476,3737
263175595620,80,4,receive,263175591787,3833
263175605881,20,4,receive,263175588615,17266
263175606581,10,4,receive,263175599197,7384
263175607025,64,4,receive,263175596883,10142
263175611600,94,4,receive,263175602429,9171
263175612035,28,5,receive,263175603554,8481
263175612481,52,4,receive,263175607258,5223
263175612909,8,4,receive,263175611059,1850
263175621313,96,5,receive,263175619428,1885
263175623065,30,4,receive,263175622072,993
263175628162,44,4,receive,263175627561,601
263175631178,82,5,receive,263175630669,509
263175644654,22,5,receive,263175643443,1211
263175647376,26,5,receive,263175644865,2511
263175647798,54,5,receive,263175644970,2828
263175655950,98,5,receive,263175653743,2207
263175661145,90,5,receive,263175659638,1507
263175668509,2,4,receive,263175665402,3107
263175673428,12,5,receive,263175670912,2516
263175679764,76,5,receive,263175679011,753
263175699052,34,5,receive,263175679570,19482
263175699687,78,5,receive,263175681744,17943
263175700323,88,5,receive,263175682123,18200
263175705228,16,5,receive,263175687294,17934
263175705866,4,5,receive,263175687211,18655
263175706502,70,5,receive,263175688980,17522
263175710283,32,5,receive,263175688940,21343
263175710692,74,5,receive,263175689618,21074
263175713149,6,5,receive,263175690531,22618
263175722684,92,5,receive,263175692074,30610
263175723131,46,5,receive,263175694353,28778
263175723563,72,5,receive,263175700100,23463
263175727400,58,5,receive,263175700461,26939
263175727833,86,5,receive,263175710872,16961
263175728273,40,5,receive,263175713118,15155
263175728699,20,5,receive,263175716397,12302
263175729142,42,5,receive,263175716809,12333
263175735175,24,5,receive,263175717006,18169
263175735609,100,6,receive,263175722268,13341
263175739192,48,5,receive,263175729014,10178
263175741149,62,5,receive,263175730317,10832
263175744422,68,5,receive,263175730275,14147
263175744872,18,5,receive,263175734130,10742
263175745304,66,5,receive,263175736503,8801
263175745835,50,5,receive,263175738307,7528
263175746275,82,6,receive,263175739225,7050
263175746705,52,5,receive,263175739648,7057
263175752978,84,5,receive,263175741346,11632
263175753388,80,5,receive,263175742784,10604
263175753795,10,5,receive,263175742775,11020
263175754252,30,5,receive,263175745408,8844
263175755826,56,5,receive,263175747324,8502
263175756253,8,5,receive,263175751006,5247
263175756670,38,5,receive,263175754315,2355
263175759436,44,5,receive,263175757891,1545
263175764548,14,5,receive,263175762387,2161
263175772637,28,6,receive,263175771192,1445
263175777208,22,6,receive,263175775311,1897
263175791447,64,5,receive,263175790012,1435
263175797559,94,5,receive,263175791234,6325
263175798008,78,6,receive,263175792403,5605
263175800154,36,5,receive,263175794366,5788
263175800563,2,5,receive,263175794349,6214
263175802921,46,6,receive,263175798016,4905
263175803341,16,6,receive,263175799292,4049
263175811031,98,6,receive,263175803363,7668
263175819441,60,5,receive,263175808905,10536
263175819893,54,6,receive,263175809736,10157
263175820342,96,6,receive,263175812674,7668
263175820776,32,6,receive,263175818350,2426
263175825076,72,6,receive,263175821011,4065
263175839623,86,6,receive,263175837076,2547
263175840058,34,6,receive,263175837768,2290
263175844740,26,6,receive,263175842537,2203
263175846854,4,6,receive,263175846222,632
263175852388,70,6,receive,263175849330,3058
263175854302,88,6,receive,263175853092,1210
263175864783,82,7,receive,263175860963,3820
263175865228,12,6,receive,263175862037,3191
263175868234,24,6,receive,263175865275,2959
263175874859,50,6,receive,263175867143,7716
263175875282,68,6,receive,263175867789,7493
263175875709,90,6,receive,263175870351,5358
263175884024,8,6,receive,263175871080,12944
263175886291,6,6,receive,263175875890,10401
263175887248,92,6,receive,263175876267,10981
263175887667,10,6,receive,263175880902,6765
263175888108,28,7,receive,263175881257,6851
263175888549,40,6,receive,263175886431,2118
263175895915,100,7,receive,263175889093,6822
263175896364,44,6,receive,263175893193,3171
263175896799,58,6,receive,263175893368,3431
263175900723,66,6,receive,263175897870,2853
263175901174,48,6,receive,263175898320,2854
263175901606,74,6,receive,263175898277,3329
263175904198,18,6,receive,263175901816,2382
263175904631,30,6,receive,263175903490,1141
263175909580,22,7,receive,263175906262,3318
263175910873,42,6,receive,263175906731,4142
263175911312,52,6,receive,263175909751,1561
263175914619,78,7,receive,263175913672,947
263175916540,14,6,receive,263175915991,549
263175920664,62,6,receive,263175918272,2392
263175923142,76,6,receive,263175920518,2624
263175923570,56,6,receive,263175920887,2683
263175923991,20,6,receive,263175921268,2723
263175924441,80,6,receive,263175921864,2577
263175937895,96,7,receive,263175935071,2824
263175939473,64,6,receive,263175935753,3720
263175939907,60,6,receive,263175938070,1837
263175944283,38,6,receive,263175940078,4205
263175944723,46,7,receive,263175939988,4735
263175950321,36,6,receive,263175948508,1813
263175956606,84,6,receive,263175955398,1208
263175959817,94,6,receive,263175958439,1378
263175971522,70,7,receive,263175970351,1171
263175986138,34,7,receive,263175984289,1849
263175986540,24,7,receive,263175985689,851
263175993397,98,7,receive,263175991147,2250
263175997323,2,6,receive,263175993968,3355
263175997736,4,7,receive,263175995640,2096
263176001358,82,8,receive,263175996809,4549
263176002029,54,7,receive,263176000794,1235
263176002466,6,7,receive,263176001310,1156
263176011631,88,7,receive,263176005449,6182
263176012080,50,7,receive,263176008990,3090
263176016038,16,7,receive,263176013426,2612
263176016483,18,7,receive,263176015544,939
263176019296,72,7,receive,263176018338,958
263176022304,48,7,receive,263176019275,3029
263176022730,8,7,receive,263176019993,2737
263176023168,12,7,receive,263176020779,2389
263176035316,86,7,receive,263176031152,4164
263176035757,66,7,receive,263176031625,4132
263176038422,32,7,receive,263176033835,4587
263176041797,20,7,receive,263176036068,5729
263176042215,92,7,receive,263176038677,3538
263176051060,26,7,receive,263176048089,2971
263176051493,78,8,receive,263176049759,1734
263176056556,36,7,receive,263176053616,2940
263176057556,22,8,receive,263176054107,3449
263176057975,52,7,receive,263176056792,1183
263176065035,42,7,receive,263176060066,4969
263176065471,28,8,receive,263176060925,4546
263176069027,90,7,receive,263176064587,4440
263176074224,44,7,receive,263176066574,7650
263176074634,68,7,receive,263176069012,5622
263176084064,74,7,receive,263176070302,13762
263176084507,76,7,receive,263176074571,9936
263176084933,100,8,receive,263176079009,5924
263176087475,40,7,receive,263176081390,6085
263176087881,10,7,receive,263176081787,6094
263176094103,94,7,receive,263176088825,5278
263176101834,56,7,receive,263176100815,1019
263176103112,46,8,receive,263176102450,662
263176106108,58,7,receive,263176105287,821
263176112135,98,8,receive,263176107122,5013
263176112552,62,7,receive,263176111047,1505
263176115362,60,7,receive,263176113546,1816
263176117544,30,7,receive,263176116171,1373
263176120041,14,7,receive,263176119444,597
263176121704,96,8,receive,263176121194,510
263176130539,80,7,receive,263176124200,6339
263176131184,64,7,receive,263176124601,6583
263176131629,84,7,receive,263176127914,3715
263176139103,38,7,receive,263176134791,4312
263176147210,4,8,receive,263176142202,5008
263176147850,20,8,receive,263176143743,4107
263176151023,2,7,receive,263176147956,3067
263176155210,32,8,receive,263176151733,3477
263176159823,16,8,receive,263176157005,2818
263176161183,88,8,receive,263176160839,344
263176168616,82,9,receive,263176168011,605
263176169176,70,8,receive,263176168008,1168
263176170622,66,8,receive,263176169872,750
263176171244,42,8,receive,263176170072,1172
263176174404,72,8,receive,263176174012,392
263176180044,78,9,receive,263176175505,4539
263176180701,22,9,receive,263176175520,5181
263176183411,50,8,receive,263176176567,6844
263176185349,48,8,receive,263176181012,4337
263176186008,90,8,receive,263176183009,2999
263176186663,24,8,receive,263176183862,2801
263176203132,100,9,receive,263176188115,15017
263176203751,92,8,receive,263176188377,15374
263176204410,26,8,receive,263176193378,11032
263176205064,18,8,receive,263176193865,11199
263176207521,40,8,receive,263176202315,5206
263176215296,6,8,receive,263176202382,12914
263176220558,36,8,receive,263176205008,15550
263176221218,34,8,receive,263176205274,15944
263176221876,54,8,receive,263176208063,13813
263176222538,68,8,receive,263176214013,8525
263176235916,12,8,receive,263176214080,21836
263176236380,76,8,receive,263176219189,17191
263176236812,58,8,receive,263176219896,16916
263176237262,8,8,receive,263176223128,14134
263176237691,46,9,receive,263176229445,8246
263176244934,28,9,receive,263176241408,3526
263176245595,44,8,receive,263176233142,12453
263176246263,86,8,receive,263176243497,2766
263176252253,38,8,receive,263176246556,5697
263176254400,30,8,receive,263176252253,2147
263176261854,94,8,receive,263176261216,638
263176264788,74,8,receive,263176264223,565
263176266233,52,8,receive,263176265234,999
263176272394,56,8,receive,263176270217,2177
263176273218,84,8,receive,263176271218,2000
263176277591,80,8,receive,263176274414,3177
263176280759,14,8,receive,263176279487,1272
263176283756,20,9,receive,263176282590,1166
263176289998,10,8,receive,263176287465,2533
263176293226,60,8,receive,263176291176,2050
263176293879,82,10,receive,263176291960,1919
263176302570,100,10,receive,263176294514,8056
263176303129,66,9,receive,263176296400,6729
263176303781,98,9,receive,263176297232,6549
263176304437,92,9,receive,263176302132,2305
263176305097,48,9,receive,263176302336,2761
263176324979,64,8,receive,263176296773,28206
263176325618,26,9,receive,263176307295,18323
263176326289,42,9,receive,263176309465,16824
263176326964,62,8,receive,263176309886,17078
263176327639,72,9,receive,263176315315,12324
263176340292,22,10,receive,263176317548,22744
263176340976,24,9,receive,263176317799,23177
263176341659,2,8,receive,263176321135,20524
263176342349,32,9,receive,263176324478,17871
263176355421,36,9,receive,263176324967,30454
263176355857,16,9,receive,263176328820,27037
263176356324,4,9,receive,263176329767,26557
263176356776,8,9,receive,263176330961,25815
263176357243,96,9,receive,263176337348,19895
263176357695,78,10,receive,263176340013,17682
263176358164,6,9,receive,263176348439,9725
263176358593,88,9,receive,263176349539,9054
263176362199,90,9,receive,263176361141,1058
263176364279,70,9,receive,263176363081,1198
263176369468,34,9,receive,263176368230,1238
263176375709,68,9,receive,263176374419,1290
263176378798,40,9,receive,263176378245,553
263176383868,50,9,receive,263176383272,596
263176391461,54,9,receive,263176390874,587
263176395202,46,10,receive,263176391547,3655
263176397877,18,9,receive,263176397193,684
263176402447,80,9,receive,263176401873,574
263176405113,82,11,receive,263176404559,554
263176411829,10,9,receive,263176410458,1371
263176414881,30,9,receive,263176413140,1741
263176416557,76,9,receive,263176415307,1250
263176418981,14,9,receive,263176416685,2296
263176419639,12,9,receive,263176417169,2470
263176422694,56,9,receive,263176420388,2306
263176423343,86,9,receive,263176420667,2676
263176428073,58,9,receive,263176425703,2370
263176436047,32,10,receive,263176432367,3680
263176436703,74,9,receive,263176433094,3609
263176437365,60,9,receive,263176433569,3796
263176438032,44,9,receive,263176433542,4490
263176454206,98,10,receive,263176440909,13297
263176454863,52,9,receive,263176443422,11441
263176455777,28,10,receive,263176445821,9956
263176456433,92,10,receive,263176446296,10137
263176461076,2,9,receive,263176446545,14531
263176461731,38,9,receive,263176447797,13934
263176478405,84,9,receive,263176454895,23510
263176479071,96,10,receive,263176456388,22683
263176479727,22,11,receive,263176458010,21717
263176480389,94,9,receive,263176460088,20301
263176481054,20,10,receive,263176465107,15947
263176481713,36,10,receive,263176467013,14700
263176488949,4,10,receive,263176488192,757
263176492699,64,9,receive,263176490740,1959
263176495075,34,10,receive,263176493485,1590
263176499958,42,10,receive,263176498009,1949
263176502464,62,9,receive,263176500390,2074
263176503131,100,11,receive,263176500966,2165
263176509746,66,10,receive,263176503203,6543
263176510407,70,10,receive,263176505514,4893
263176511067,72,10,receive,263176506056,5011
263176511732,8,10,receive,263176506755,4977
263176518493,26,10,receive,263176511944,6549
263176519862,24,10,receive,263176519370,492
263176525184,48,10,receive,263176524578,606
263176527999,14,10,receive,263176527483,516
263176530566,78,11,receive,263176530082,484
263176536763,6,10,receive,263176536239,524
263176540574,16,10,receive,263176540082,492
263176543623,54,10,receive,263176543248,375
263176546416,56,10,receive,263176544409,2007
263176555101,60,10,receive,263176554493,608
263176555733,30,10,receive,263176554493,1240
263176559165,40,10,receive,263176556781,2384
263176559796,58,10,receive,263176557729,2067
263176563594,68,10,receive,263176561163,2431
263176564225,88,10,receive,263176563283,942
263176576743,10,10,receive,263176565074,11669
263176577366,90,10,receive,263176565383,11983
263176578034,46,11,receive,263176568321,9713
263176578694,18,10,receive,263176568647,10047
263176579281,86,10,receive,263176572989,6292
263176579772,84,10,receive,263176576412,3360
263176602390,38,10,receive,263176576737,25653
263176602827,28,11,receive,263176579337,23490
263176603268,20,11,receive,263176582064,21204
263176603700,2,10,receive,263176585252,18448
263176604186,80,10,receive,263176585763,18423
263176604839,12,10,receive,263176579267,25572
263176605497,52,10,receive,263176590132,15365
263176625363,74,10,receive,263176598098,27265
263176626073,50,10,receive,263176598771,27302
263176626676,82,12,receive,263176598924,27752
263176627339,44,10,receive,263176599822,27517
263176627989,76,10,receive,263176607007,20982
263176628690,4,11,receive,263176608403,20287
263176650453,72,11,receive,263176614007,36446
263176651065,96,11,receive,263176621094,29971
263176651723,42,11,receive,263176623950,27773
263176652383,92,11,receive,263176624765,27618
263176652996,22,12,receive,263176625772,27224
263176653531,32,11,receive,263176628154,25377
263176674120,24,11,receive,263176629629,44491
263176674771,62,10,receive,263176624352,50419
263176675428,94,10,receive,263176637483,37945
263176676084,98,11,receive,263176639466,36618
263176676736,64,10,receive,263176649903,26833
263176681604,36,11,receive,263176650155,31449
263176682192,54,11,receive,263176657063,25129
263176682851,26,11,receive,263176678123,4728
263176683509,56,11,receive,263176679237,4272
263176684168,46,12,receive,263176680785,3383
263176684829,34,11,receive,263176680786,4043
263176704273,66,11,receive,263176682710,21563
263176704929,100,12,receive,263176693897,11032
263176705544,90,11,receive,263176694855,10689
263176706205,18,11,receive,263176695463,10742
263176713276,6,11,receive,263176696602,16674
263176713934,28,12,receive,263176699759,14175
263176723650,48,11,receive,263176701607,22043
263176724314,88,11,receive,263176701947,22367
263176724973,70,11,receive,263176702101,22872
263176725574,14,11,receive,263176702275,23299
263176726116,16,11,receive,263176706500,19616
263176726778,44,11,receive,263176708983,17795
263176738250,8,11,receive,263176714010,24240
263176738924,76,11,receive,263176719073,19851
263176744621,78,12,receive,263176729267,15354
263176747437,30,11,receive,263176729690,17747
263176748098,22,13,receive,263176734237,13861
263176748755,82,13,receive,263176736335,12420
263176762467,10,11,receive,263176737270,25197
263176763119,38,11,receive,263176734549,28570
263176763761,58,11,receive,263176738784,24977
263176764409,12,11,receive,263176740061,24348
263176765062,80,11,receive,263176742249,22813
263176765691,84,11,receive,263176744794,20897
263176782109,96,12,receive,263176753916,28193
263176782753,42,12,receive,263176755224,27529
263176783360,68,11,receive,263176755625,27735
263176784015,40,11,receive,263176756927,27088
263176784674,24,12,receive,263176761823,22851
263176801346,72,12,receive,263176763281,38065
263176802012,50,11,receive,263176763813,38199
263176802668,20,12,receive,263176765008,37660
263176807576,92,12,receive,263176771667,35909
263176808238,98,12,receive,263176781490,26748
263176808891,86,11,receive,263176782667,26224
263176821553,60,11,receive,263176773807,47746
263176822215,52,11,receive,263176788073,34142
263176822873,36,12,receive,263176789927,32946
263176823581,62,11,receive,263176791933,31648
263176840246,74,11,receive,263176793184,47062
263176840894,54,12,receive,263176794458,46436
263176841557,2,11,receive,263176798590,42967
263176842216,64,11,receive,263176802898,39318
263176843163,4,12,receive,263176807061,36102
263176843815,46,13,receive,263176810012,33803
263176857831,26,12,receive,263176815160,42671
263176858520,32,12,receive,263176819320,39200
263176859208,88,12,receive,263176824072,35136
263176859882,94,11,receive,263176825381,34501
263176860533,6,12,receive,263176828724,31809
263176861210,76,12,receive,263176833006,28204
263176861884,16,12,receive,263176837099,24785
263176862565,28,13,receive,263176842192,20373
263176863246,14,12,receive,263176845313,17933
263176863789,12,12,receive,263176852123,11666
263176864947,56,12,receive,263176854191,10756
263176865405,82,14,receive,263176863841,1564
263176869974,66,12,receive,263176867592,2382
263176875479,72,13,receive,263176874397,1082
263176882900,100,13,receive,263176876596,6304
263176883327,48,12,receive,263176876504,6823
263176883760,30,12,receive,263176876534,7226
263176884213,20,13,receive,263176876780,7433
263176884649,34,12,receive,263176881647,3002
263176895128,42,13,receive,263176887160,7968
263176895692,18,12,receive,263176889322,6370
263176896139,8,12,receive,263176890930,5209
263176896573,24,13,receive,263176893538,3035
263176897016,70,12,receive,263176894532,2484
263176897455,52,12,receive,263176895264,2191
263176903067,58,12,receive,263176898414,4653
263176908461,40,12,receive,263176908005,456
263176911514,44,12,receive,263176908568,2946
263176911958,68,12,receive,263176909679,2279
263176912528,96,13,receive,263176910154,2374
263176918596,10,12,receive,263176912165,6431
263176919070,90,12,receive,263176915669,3401
263176919520,22,14,receive,263176916079,3441
263176924695,78,13,receive,263176919861,4834
263176926719,54,13,receive,263176925582,1137
263176927176,64,12,receive,263176925534,1642
263176927634,80,12,receive,263176926406,1228
263176930209,60,12,receive,263176927363,2846
263176933270,36,13,receive,263176929265,4005
263176937371,62,12,receive,263176936429,942
263176938568,26,13,receive,263176937956,612
263176943336,86,12,receive,263176942806,530
263176947082,38,12,receive,263176946188,894
263176951998,84,12,receive,263176951018,980
263176963965,92,13,receive,263176961268,2697
263176974891,28,14,receive,263176972783,2108
263176977387,50,12,receive,263176975330,2057
263176981393,6,13,receive,263176979286,2107
263176984992,16,13,receive,263176983301,1691
263176991286,74,12,receive,263176984789,6497
263176991736,42,14,receive,263176988355,3381
263176994129,2,12,receive,263176989294,4835
263177003974,76,13,receive,263176991560,12414
263177004400,20,14,receive,263176994064,10336
263177004813,98,13,receive,263176997867,6946
263177005234,46,14,receive,263176998014,7220
263177008427,56,13,receive,263177007577,850
263177010262,12,13,receive,263177009534,728
263177014246,8,13,receive,263177013534,712
263177023272,4,13,receive,263177021439,1833
263177027279,24,14,receive,263177023484,3795
263177027736,10,13,receive,263177025802,1934
263177045231,94,12,receive,263177027087,18144
263177045691,90,13,receive,263177028114,17577
263177046136,40,13,receive,263177029199,16937
263177046578,32,13,receive,263177029520,17058
263177047045,22,15,receive,263177030630,16415
263177047511,64,13,receive,263177034074,13437
263177047967,88,13,receive,263177035291,12676
263177048433,82,15,receive,263177038006,10427
263177048886,34,13,receive,263177039510,9376
263177066335,80,13,receive,263177039705,26630
263177066786,14,13,receive,263177044604,22182
263177067241,70,13,receive,263177050018,17223
263177067689,86,13,receive,263177056409,11280
263177068147,54,14,receive,263177056803,11344
263177068596,44,13,receive,263177057228,11368
263177078557,60,13,receive,263177062124,16433
263177079026,48,13,receive,263177065673,13353
263177079508,66,13,receive,263177070711,8797
263177079985,30,13,receive,263177074834,5151
263177084388,100,14,receive,263177080507,3881
263177102605,96,14,receive,263177095518,7087
263177103065,36,14,receive,263177096272,6793
263177103520,58,13,receive,263177097675,5845
263177103968,52,13,receive,263177101399,2569
263177114427,18,13,receive,263177104969,9458
263177114950,72,14,receive,263177106921,8029
263177115415,68,13,receive,263177113368,2047
263177115858,50,13,receive,263177114695,1163
263177129057,92,14,receive,263177121668,7389
263177130695,98,14,receive,263177125366,5329
263177131267,28,15,receive,263177126453,4814
263177143065,62,13,receive,263177129011,14054
263177155444,78,14,receive,263177131501,23943
263177156116,12,14,receive,263177134670,21446
263177156773,56,14,receive,263177135185,21588
263177157441,84,13,receive,263177135221,22220
263177158042,38,13,receive,263177135258,22784
263177158475,20,15,receive,263177137125,21350
263177158905,16,14,receive,263177138805,20100
263177184423,40,14,receive,263177148681,35742
263177184830,4,14,receive,263177151403,33427
263177188299,74,13,receive,263177158858,29441
263177188711,10,14,receive,263177139256,49455
263177189122,42,15,receive,263177162445,26677
263177191867,76,14,receive,263177163120,28747
263177192313,26,14,receive,263177164353,27960
263177192751,60,14,receive,263177174138,18613
263177199989,80,14,receive,263177177064,22925
263177200411,6,14,receive,263177185011,15400
263177202158,46,15,receive,263177189247,12911
263177202598,34,14,receive,263177189411,13187
263177203088,2,13,receive,263177191356,11732
263177203505,94,13,receive,263177197679,5826
263177206176,86,14,receive,263177203461,2715
263177209469,70,14,receive,263177207753,1716
263177210186,82,16,receive,263177209458,728
263177224241,32,14,receive,263177212789,11452
263177224689,14,14,receive,263177214631,10058
263177225158,36,15,receive,263177216913,8245
263177227287,22,16,receive,263177226078,1209
263177228205,8,14,receive,263177227424,781
263177245423,96,15,receive,263177228970,16453
263177245869,88,14,receive,263177229363,16506
263177246326,68,14,receive,263177230244,16082
263177246782,54,15,receive,263177231549,15233
263177247247,48,14,receive,263177232624,14623
263177247694,24,15,receive,263177235418,12276
263177248144,90,14,receive,263177235349,12795
263177248599,72,15,receive,263177238894,9705
263177261057,64,14,receive,263177241130,19927
263177261560,52,14,receive,263177241555,20005
263177266177,58,14,receive,263177246571,19606
263177266626,30,14,receive,263177248015,18611
263177267083,100,15,receive,263177250005,17078
263177267536,20,16,receive,263177250064,17472
263177277106,44,14,receive,263177258492,18614
263177279215,12,15,receive,263177260210,19005
263177279643,84,14,receive,263177260564,19079
263177280070,98,15,receive,263177256418,23652
263177280501,50,14,receive,263177263560,16941
263177280933,40,15,receive,263177267538,13395
263177281380,92,15,receive,263177271121,10259
263177281813,66,14,receive,263177273010,8803
263177282249,56,15,receive,263177260201,22048
263177301564,76,15,receive,263177297063,4501
263177302013,28,16,receive,263177296995,5018
263177310019,18,14,receive,263177307885,2134
263177315651,16,15,receive,263177313059,2592
263177325169,86,15,receive,263177323576,1593
263177327923,10,15,receive,263177326171,1752
263177331746,62,14,receive,263177328318,3428
263177336236,6,15,receive,263177333654,2582
263177340567,38,14,receive,263177337437,3130
263177342825,94,14,receive,263177341640,1185
263177344847,88,15,receive,263177343124,1723
263177350097,78,15,receive,263177348428,1669
263177351616,4,15,receive,263177350014,1602
263177358036,60,15,receive,263177353042,4994
263177358694,74,14,receive,263177355938,2756
263177362240,26,15,receive,263177359235,3005
263177363014,36,16,receive,263177359720,3294
263177363655,14,15,receive,263177362173,1482
263177364317,46,16,receive,263177362351,1966
263177371711,52,15,receive,263177368537,3174
263177373124,72,16,receive,263177371622,1502
263177375730,42,16,receive,263177373774,1956
263177376392,58,15,receive,263177374281,2111
263177380254,80,15,receive,263177374673,5581
263177380904,68,15,receive,263177377180,3724
263177388046,12,16,receive,263177379006,9040
263177388693,34,15,receive,263177379644,9049
263177389354,54,16,receive,263177384692,4662
263177390018,22,17,receive,263177384796,5222
263177401352,70,15,receive,263177390794,10558
263177402032,82,17,receive,263177400123,1909
263177407162,2,14,receive,263177401062,6100
263177407814,40,16,receive,263177401332,6482
263177408468,30,15,receive,263177405406,3062
263177412560,96,16,receive,263177411175,1385
263177414766,24,16,receive,263177412786,1980
263177417839,100,16,receive,263177415726,2113
263177425327,56,16,receive,263177423783,1544
263177432901,44,15,receive,263177427788,5113
263177433566,32,15,receive,263177428417,5149
263177434230,48,15,receive,263177432370,1860
263177434936,20,17,receive,263177434393,543
263177452230,64,15,receive,263177436077,16153
263177452646,90,15,receive,263177436504,16142
263177453081,62,15,receive,263177437628,15453
263177453513,66,15,receive,263177439189,14324
263177453945,8,15,receive,263177442660,11285
263177454420,18,15,receive,263177447579,6841
263177454877,28,17,receive,263177450005,4872
263177455315,98,16,receive,263177451061,4254
263177470422,84,15,receive,263177457551,12871
263177470854,92,16,receive,263177457794,13060
263177471287,76,16,receive,263177458569,12718
263177471716,50,15,receive,263177459786,11930
263177472153,10,16,receive,263177468559,3594
263177481374,4,16,receive,263177478735,2639
263177484196,16,16,receive,263177481504,2692
263177496512,86,16,receive,263177491494,5018
263177502599,22,18,receive,263177493501,9098
263177505318,68,16,receive,263177496730,8588
263177505745,46,17,receive,263177496890,8855
263177506169,94,15,receive,263177501238,4931
263177506583,74,15,receive,263177502695,3888
263177506998,26,16,receive,263177504503,2495
263177513193,34,16,receive,263177507578,5615
263177516557,24,17,receive,263177513784,2773
263177516973,70,16,receive,263177514728,2245
263177517391,36,17,receive,263177515468,1923
263177526270,80,16,receive,263177517839,8431
263177526681,88,16,receive,263177515401,11280
263177527091,82,18,receive,263177524896,2195
263177534475,96,17,receive,263177532989,1486
263177541406,40,17,receive,263177539647,1759
263177541829,60,16,receive,263177539829,2000
263177544706,6,16,receive,263177542101,2605
263177548801,2,15,receive,263177545207,3594
263177550079,14,16,receive,263177549597,482
263177550676,38,15,receive,263177550095,581
263177555610,54,17,receive,263177552639,2971
263177556032,58,16,receive,263177554561,1471
263177556440,78,16,receive,263177555012,1428
263177564118,52,16,receive,263177556998,7120
263177564719,98,17,receive,263177562724,1995
263177567316,64,16,receive,263177566564,752
263177571335,30,16,receive,263177569864,1471
263177572169,20,18,receive,263177571658,511
263177575053,44,16,receive,263177573480,1573
263177583344,42,17,receive,263177582187,1157
263177587764,56,17,receive,263177585190,2574
263177590834,72,17,receive,263177585286,5548
263177593109,12,17,receive,263177590930,2179
263177597259,100,17,receive,263177595288,1971
263177604882,66,16,receive,263177603081,1801
263177609180,90,16,receive,263177606212,2968
263177614859,86,17,receive,263177613368,1491
263177618125,94,16,receive,263177615486,2639
263177618558,18,16,receive,263177616325,2233
263177626263,68,17,receive,263177623862,2401
263177628632,76,17,receive,263177626535,2097
263177629516,92,17,receive,263177628820,696
263177633691,48,16,receive,263177630355,3336
263177642030,34,17,receive,263177639711,2319
263177642451,50,16,receive,263177640408,2043
263177646156,74,16,receive,263177643702,2454
263177646583,24,18,receive,263177644398,2185
263177647012,32,16,receive,263177645062,1950
263177656276,62,16,receive,263177653401,2875
263177658216,40,18,receive,263177657104,1112
263177660573,8,16,receive,263177659258,1315
263177665473,88,17,receive,263177662558,2915
263177665891,10,17,receive,263177662528,3363
263177666376,28,18,receive,263177664178,2198
263177671306,4,17,receive,263177668697,2609
263177677512,70,17,receive,263177672441,5071
263177678013,36,18,receive,263177674072,3941
263177681564,16,17,receive,263177678709,2855
263177686109,22,19,receive,263177682766,3343
263177686525,84,16,receive,263177683225,3300
263177696659,60,17,receive,263177693587,3072
263177697093,46,18,receive,263177695612,1481
263177701620,26,17,receive,263177698764,2856
263177702287,96,18,receive,263177699820,2467
263177720144,80,17,receive,263177714081,6063
263177720785,14,17,receive,263177716087,4698
263177721430,38,16,receive,263177717795,3635
263177722077,64,17,receive,263177717907,4170
263177734841,6,17,receive,263177719978,14863
263177735298,52,17,receive,263177723172,12126
263177735750,20,19,receive,263177723841,11909
263177736181,98,18,receive,263177725496,10685
263177736607,54,18,receive,263177729558,7049
263177740337,82,19,receive,263177738153,2184
263177741261,30,17,receive,263177740442,819
263177751802,78,17,receive,263177748244,3558
263177752441,68,18,receive,263177748493,3948
263177754021,18,17,receive,263177753219,802
263177756484,44,17,receive,263177755251,1233
263177757645,58,17,receive,263177756502,1143
263177758294,24,19,receive,263177756899,1395
263177769047,2,16,receive,263177761554,7493
263177770205,92,18,receive,263177769831,374
263177771331,90,17,receive,263177770927,404
263177774109,86,18,receive,263177771808,2301
263177779106,76,18,receive,263177777149,1957
263177779739,56,18,receive,263177778664,1075
263177784994,66,17,receive,263177783691,1303
263177788653,42,18,receive,263177788187,466
263177790603,28,19,receive,263177789131,1472
263177795909,100,18,receive,263177795535,374
263177796609,62,17,receive,263177795786,823
263177803048,50,17,receive,263177798939,4109
263177803691,72,18,receive,263177799161,4530
263177806832,16,18,receive,263177799816,7016
263177807255,4,18,receive,263177806357,898
263177812048,12,18,receive,263177808817,3231
263177812690,84,17,receive,263177810557,2133
263177813335,34,18,receive,263177811024,2311
263177826048,8,17,receive,263177815668,10380
263177826693,40,19,receive,263177818312,8381
263177827338,32,17,receive,263177819653,7685
263177830404,60,18,receive,263177826468,3936
263177831049,48,17,receive,263177830011,1038
263177837603,94,17,receive,263177834211,3392
263177838257,10,18,receive,263177835094,3163
263177843282,74,17,receive,263177840008,3274
263177845360,54,19,receive,263177843011,2349
263177846772,46,19,receive,263177846282,490
263177847970,80,18,receive,263177847581,389
263177848845,20,20,receive,263177848069,776
263177858955,14,18,receive,263177853565,5390
263177863093,82,20,receive,263177860716,2377
263177864078,88,18,receive,263177862293,1785
263177864747,6,18,receive,263177862986,1761
263177872880,70,18,receive,263177861351,11529
263177877298,68,19,receive,263177876892,406
263177878072,52,18,receive,263177877348,724
263177881188,22,20,receive,263177880549,639
263177882064,18,18,receive,263177881498,566
263177892898,36,19,receive,263177882821,10077
263177893567,30,18,receive,263177883195,10372
263177894240,90,18,receive,263177892510,1730
263177901059,44,18,receive,263177893017,8042
263177901524,26,18,receive,263177896050,5474
263177901956,96,19,receive,263177896474,5482
263177913424,42,19,receive,263177911383,2041
263177914964,62,18,receive,263177914554,410
263177921952,58,18,receive,263177921423,529
263177926563,72,19,receive,263177925971,592
263177930401,64,18,receive,263177929962,439
263177932932,86,19,receive,263177932500,432
263177942317,78,18,receive,263177941767,550
263177944359,12,19,receive,263177943912,447
263177946902,74,18,receive,263177946492,410
263177950797,4,19,receive,263177949756,1041
263177951398,98,19,receive,263177950431,967
263177956678,38,17,receive,263177953007,3671
263177958359,54,20,receive,263177953390,4969
263177959019,2,17,receive,263177956785,2234
263177959677,94,18,receive,263177957351,2326
263177969493,24,20,receive,263177962071,7422
263177970153,32,18,receive,263177962351,7802
263177975667,40,20,receive,263177974087,1580
263177983164,84,18,receive,263177977174,5990
263177983801,66,18,receive,263177978250,5551
263177984466,56,19,receive,263177978468,5998
263177985129,8,18,receive,263177978860,6269
263178003802,10,19,receive,263177982927,20875
263178004475,92,19,receive,263177988342,16133
263178005148,80,19,receive,263177988511,16637
263178005815,28,20,receive,263177989843,15972
263178006489,48,18,receive,263177990007,16482
263178017228,22,21,receive,263177994112,23116
263178020259,70,19,receive,263177997481,22778
263178020905,50,18,receive,263177999013,21892
263178021572,16,19,receive,263177999464,22108
263178022231,100,19,receive,263178002813,19418
263178022890,6,19,receive,263178010155,12735
263178040225,76,19,receive,263177998664,41561
263178040879,30,19,receive,263178012763,28116
263178041538,34,19,receive,263178010320,31218
263178042203,82,21,receive,263178017437,24766
263178057020,42,20,receive,263178024792,32228
263178057451,90,19,receive,263178023362,34089
263178057893,68,20,receive,263178031059,26834
263178058349,60,19,receive,263178022438,35911
263178058799,46,20,receive,263178035351,23448
263178059259,88,19,receive,263178035752,23507
263178059701,14,19,receive,263178037592,22109
263178060151,20,21,receive,263178039006,21145
263178060591,18,19,receive,263178039320,21271
263178062867,52,19,receive,263178047065,15802
263178063298,96,20,receive,263178050031,13267
263178068406,62,19,receive,263178054005,14401
263178068853,78,19,receive,263178060589,8264
263178069305,2,18,receive,263178063502,5803
263178069745,98,20,receive,263178066457,3288
263178075555,24,21,receive,263178074923,632
263178084771,44,19,receive,263178083812,959
263178085321,4,20,receive,263178084453,868
263178093556,72,20,receive,263178085837,7719
263178094005,26,19,receive,263178088977,5028
263178097819,36,20,receive,263178097099,720
263178100446,94,19,receive,263178097201,3245
263178108099,22,22,receive,263178106937,1162
263178117574,70,20,receive,263178115367,2207
263178121527,6,20,receive,263178120306,1221
263178127536,92,20,receive,263178124606,2930
263178127989,12,20,receive,263178125794,2195
263178133194,38,18,receive,263178129363,3831
263178133655,58,19,receive,263178129613,4042
263178134116,42,21,receive,263178130789,3327
263178140202,86,20,receive,263178134189,6013
263178140628,30,20,receive,263178137429,3199
263178141066,64,19,receive,263178138722,2344
263178153189,54,21,receive,263178144527,8662
263178154018,90,20,receive,263178144891,9127
263178154467,50,19,receive,263178146005,8462
263178154914,80,20,receive,263178152152,2762
263178155375,16,20,receive,263178152534,2841
263178155830,20,22,receive,263178153296,2534
263178168303,14,20,receive,263178156249,12054
263178168719,74,19,receive,263178159310,9409
263178169179,8,19,receive,263178159874,9305
263178169613,40,21,receive,263178162041,7572
263178170045,18,20,receive,263178162177,7868
263178171131,82,22,receive,263178170014,1117
263178171546,84,19,receive,263178170434,1112
263178174028,60,20,receive,263178173090,938
263178178842,66,19,receive,263178175662,3180
263178179280,48,19,receive,263178177466,1814
263178181348,88,20,receive,263178179499,1849
263178185474,56,20,receive,263178185032,442
263178186530,34,20,receive,263178186006,524
263178187861,100,20,receive,263178187411,450
263178189390,98,21,receive,263178188787,603
263178190989,32,19,receive,263178189999,990
263178191444,28,21,receive,263178190335,1109
263178194107,10,20,receive,263178191292,2815
263178194524,78,20,receive,263178191659,2865
263178200064,52,20,receive,263178195110,4954
263178200504,24,22,receive,263178197257,3247
263178212759,68,21,receive,263178212123,636
263178214452,96,21,receive,263178213895,557
263178217498,76,20,receive,263178214844,2654
263178220433,46,21,receive,263178219768,665
263178225996,22,23,receive,263178225356,640
263178227690,62,20,receive,263178226843,847
263178246600,4,21,receive,263178245681,919
263178247481,2,19,receive,263178246294,1187
263178257298,86,21,receive,263178254578,2720
263178257964,26,20,receive,263178255718,2246
263178261706,36,21,receive,263178260247,1459
263178268442,72,21,receive,263178266091,2351
263178273197,44,20,receive,263178271646,1551
263178288402,38,19,receive,263178286885,1517
263178292352,8,20,receive,263178291595,757
263178297624,18,21,receive,263178295583,2041
263178298576,94,20,receive,263178297529,1047
263178308209,40,22,receive,263178299535,8674
263178310211,42,22,receive,263178301232,8979
263178310857,80,21,receive,263178304611,6246
263178311505,88,21,receive,263178304575,6930
263178323156,30,21,receive,263178311471,11685
263178323798,92,21,receive,263178314094,9704
263178324654,84,20,receive,263178314735,9919
263178325303,70,21,receive,263178316271,9032
263178329181,6,21,receive,263178316987,12194
263178329827,10,21,receive,263178320430,9397
263178336361,50,20,receive,263178323978,12383
263178336997,58,20,receive,263178324582,12415
263178337648,60,21,receive,263178327819,9829
263178343170,76,21,receive,263178332376,10794
263178353331,20,23,receive,263178335166,18165
263178353973,82,23,receive,263178338670,15303
263178354619,16,21,receive,263178341541,13078
263178355261,90,21,receive,263178342620,12641
263178355901,54,22,receive,263178343609,12292
263178356546,64,20,receive,263178345226,11320
263178361872,14,21,receive,263178349360,12512
263178362537,12,21,receive,263178350138,12399
263178363201,24,23,receive,263178360288,2913
263178373832,62,21,receive,263178360343,13489
263178374496,34,21,receive,263178364756,9740
263178389743,56,21,receive,263178364846,24897
263178390411,46,22,receive,263178365206,25205
263178391077,74,20,receive,263178365725,25352
263178391746,100,21,receive,263178372904,18842
263178392412,52,21,receive,263178375371,17041
263178404072,28,22,receive,263178377273,26799
263178404701,78,21,receive,263178379520,25181
263178412157,48,20,receive,263178379967,32190
263178412782,66,20,receive,263178381860,30922
263178413220,98,22,receive,263178388345,24875
263178413651,96,22,receive,263178386202,27449
263178414100,32,20,receive,263178399426,14674
263178414557,44,21,receive,263178404951,9606
263178414984,86,22,receive,263178407277,7707
263178420472,72,22,receive,263178419959,513
263178424151,22,24,receive,263178422364,1787
263178433232,8,21,receive,263178425922,7310
263178433924,70,22,receive,263178429979,3945
263178434588,68,22,receive,263178432800,1788
263178435172,58,21,receive,263178433463,1709
263178435735,50,21,receive,263178435165,570
263178455907,4,22,receive,263178437429,18478
263178456575,92,22,receive,263178438495,18080
263178457253,2,20,receive,263178451573,5680
263178457909,80,22,receive,263178455447,2462
263178466936,64,21,receive,263178458068,8868
263178467382,40,23,receive,263178460761,6621
263178467820,6,22,receive,263178463912,3908
263178485436,12,22,receive,263178468120,17316
263178486099,38,20,receive,263178470674,15425
263178486756,54,23,receive,263178471070,15686
263178487419,26,21,receive,263178471189,16230
263178488080,18,22,receive,263178467331,20749
263178488740,94,21,receive,263178473305,15435
263178506762,36,22,receive,263178474177,32585
263178507425,84,21,receive,263178474133,33292
263178507860,88,22,receive,263178477114,30746
263178508297,14,22,receive,263178481076,27221
263178508729,42,23,receive,263178485013,23716
263178509167,60,22,receive,263178492095,17072
263178509697,30,22,receive,263178498073,11624
263178526799,78,22,receive,263178506188,20611
263178527460,46,23,receive,263178513363,14097
263178528111,82,24,receive,263178515246,12865
263178528770,20,24,receive,263178515181,13589
263178529431,76,22,receive,263178519256,10175
263178552124,90,22,receive,263178525868,26256
263178552842,10,22,receive,263178526489,26353
263178553468,34,22,receive,263178534204,19264
263178554077,100,22,receive,263178537396,16681
263178554679,56,22,receive,263178539428,15251
263178569361,68,23,receive,263178541422,27939
263178570025,22,25,receive,263178542396,27629
263178570686,16,22,receive,263178542371,28315
263178582271,8,22,receive,263178551459,30812
263178582929,52,22,receive,263178552320,30609
263178594194,50,22,receive,263178552765,41429
263178594858,96,23,receive,263178557017,37841
263178595513,62,22,receive,263178552060,43453
263178596181,48,21,receive,263178562620,33561
263178596849,72,23,receive,263178565311,31538
263178613673,32,21,receive,263178567051,46622
263178614341,2,21,receive,263178570917,43424
263178614998,58,22,receive,263178573254,41744
263178615660,74,21,receive,263178573850,41810
263178616324,24,24,receive,263178577097,39227
263178629596,44,22,receive,263178578855,50741
263178630048,66,21,receive,263178582846,47202
263178630500,64,22,receive,263178585235,45265
263178630973,98,23,receive,263178596594,34379
263178631451,28,23,receive,263178597099,34352
263178631909,4,23,receive,263178597786,34123
263178636410,14,23,receive,263178604675,31735
263178636858,70,23,receive,263178607209,29649
263178637396,86,23,receive,263178608286,29110
263178645319,26,22,receive,263178611121,34198
263178645817,84,22,receive,263178616425,29392
263178649284,60,23,receive,263178620188,29096
263178649732,42,24,receive,263178620302,29430
263178650231,94,22,receive,263178632220,18011
263178650704,38,21,receive,263178637255,13449
263178651183,88,23,receive,263178638432,12751
263178651650,30,23,receive,263178639579,12071
263178652118,34,23,receive,263178645946,6172
263178657163,54,24,receive,263178655438,1725
263178660038,12,23,receive,263178657359,2679
263178660467,18,23,receive,263178659403,1064
263178668070,92,23,receive,263178662352,5718
263178668522,6,23,receive,263178664520,4002
263178673813,16,23,receive,263178671588,2225
263178680947,40,24,receive,263178674288,6659
263178681404,48,22,receive,263178674162,7242
263178681847,80,23,receive,263178678349,3498
263178689046,36,23,receive,263178686365,2681
263178695190,8,23,receive,263178691875,3315
263178695628,68,24,receive,263178692116,3512
263178701738,52,23,receive,263178697129,4609
263178702188,74,22,receive,263178698894,3294
263178711954,78,23,receive,263178705429,6525
263178712408,90,23,receive,263178705684,6724
263178712844,82,25,receive,263178707267,5577
263178720523,28,24,receive,263178707460,13063
263178720997,72,24,receive,263178708442,12555
263178721447,10,23,receive,263178712847,8600
263178721892,22,26,receive,263178714371,7521
263178722341,46,24,receive,263178715796,6545
263178722781,76,23,receive,263178715768,7013
263178736438,58,23,receive,263178716070,20368
263178736874,50,23,receive,263178718614,18260
263178737344,20,25,receive,263178720123,17221
263178737773,56,23,receive,263178724386,13387
263178738218,62,23,receive,263178731814,6404
263178738650,60,24,receive,263178732708,5942
263178739087,98,24,receive,263178735061,4026
263178750302,66,22,receive,263178741384,8918
263178750726,86,24,receive,263178745601,5125
263178751166,100,23,receive,263178746675,4491
263178751585,26,23,receive,263178736072,15513
263178753762,14,24,receive,263178752128,1634
263178761158,96,24,receive,263178756007,5151
263178761636,4,24,receive,263178756175,5461
263178762074,42,25,receive,263178759108,2966
263178762519,64,23,receive,263178760875,1644
263178773131,24,25,receive,263178764570,8561
263178774062,32,22,receive,263178766182,7880
263178775866,2,22,receive,263178768474,7392
263178776323,30,24,receive,263178773005,3318
263178785159,12,24,receive,263178776638,8521
263178785697,70,24,receive,263178778996,6701
263178786398,88,24,receive,263178779222,7176
263178786840,94,23,receive,263178780691,6149
263178787289,34,24,receive,263178782257,5032
263178787726,84,23,receive,263178785299,2427
263178796044,44,23,receive,263178787874,8170
263178801302,18,24,receive,263178796834,4468
263178801753,38,22,receive,263178801079,674
263178813818,68,25,receive,263178810928,2890
263178814251,92,24,receive,263178812236,2015
263178828284,58,24,receive,263178825667,2617
263178830434,36,24,receive,263178828931,1503
263178836951,56,24,receive,263178832331,4620
263178837413,40,25,receive,263178833148,4265
263178847905,62,24,receive,263178840699,7206
263178848356,80,24,receive,263178841377,6979
263178849147,16,24,receive,263178842650,6497
263178849600,72,25,receive,263178843004,6596
263178855104,78,24,receive,263178848524,6580
263178855557,98,25,receive,263178849755,5802
263178856021,48,23,receive,263178851360,4661
263178856477,74,23,receive,263178851470,5007
263178856930,82,26,receive,263178854013,2917
263178865718,10,24,receive,263178859596,6122
263178866194,90,24,receive,263178864404,1790
263178872855,54,25,receive,263178870692,2163
263178874739,32,23,receive,263178873083,1656
263178879878,6,24,receive,263178878621,1257
263178883048,8,24,receive,263178880715,2333
263178887497,52,24,receive,263178883275,4222
263178887947,22,27,receive,263178884664,3283
263178897301,28,25,receive,263178890491,6810
263178897749,24,26,receive,263178891859,5890
263178898197,96,25,receive,263178893866,4331
263178904686,76,24,receive,263178899697,4989
263178905154,86,25,receive,263178900930,4224
263178908046,60,25,receive,263178905581,2465
263178917926,34,25,receive,263178913085,4841
263178918456,50,24,receive,263178913283,5173
263178918898,14,25,receive,263178913902,4996
263178931451,66,23,receive,263178918006,13445
263178931898,20,26,receive,263178922007,9891
263178932350,46,25,receive,263178920955,11395
263178932790,2,23,receive,263178924358,8432
263178933244,18,25,receive,263178925991,7253
263178933727,92,25,receive,263178926173,7554
263178938492,70,25,receive,263178929794,8698
263178950118,100,24,receive,263178933114,17004
263178950568,36,25,receive,263178934674,15894
263178951085,84,24,receive,263178937206,13879
263178951557,26,24,receive,263178937700,13857
263178952017,42,26,receive,263178938753,13264
263178952535,4,25,receive,263178933371,19164
263178957783,12,25,receive,263178944180,13603
263178959053,64,24,receive,263178944598,14455
263178959510,88,25,receive,263178950550,8960
263178959957,62,25,receive,263178952184,7773
263178960415,68,26,receive,263178958397,2018
263178974641,30,25,receive,263178968006,6635
263178975098,38,23,receive,263178969739,5359
263178975547,56,25,receive,263178971589,3958
263178975996,94,24,receive,263178961795,14201
263178981853,44,24,receive,263178981059,794
263178982831,90,25,receive,263178981998,833
263178996714,48,24,receive,263178988939,7775
263178997160,40,26,receive,263178988618,8542
263178997588,78,25,receive,263178991008,6580
263178998028,10,25,receive,263178992167,5861
263179005288,32,24,receive,263179003541,1747
263179008608,58,25,receive,263179007563,1045
263179012190,72,26,receive,263179011536,654
263179021149,80,25,receive,263179019478,1671
263179034273,82,27,receive,263179031908,2365
263179043169,92,26,receive,263179037685,5484
263179043618,96,26,receive,263179039248,4370
263179044106,52,25,receive,263179039900,4206
263179051376,6,25,receive,263179038769,12607
263179052203,98,26,receive,263179042552,9651
263179052658,74,24,receive,263179051604,1054
263179061429,16,25,receive,263179057531,3898
263179061863,66,24,receive,263179059657,2206
263179062315,22,28,receive,263179060128,2187
263179067342,8,25,receive,263179060982,6360
263179070205,70,26,receive,263179068228,1977
263179071864,2,24,receive,263179071253,611
263179083404,60,26,receive,263179072884,10520
263179083863,42,27,receive,263179073584,10279
263179084323,54,26,receive,263179077520,6803
263179084786,86,26,receive,263179079907,4879
263179089323,24,27,receive,263179084888,4435
263179089789,18,26,receive,263179085292,4497
263179090271,46,26,receive,263179086611,3660
263179101345,64,25,receive,263179088728,12617
263179101803,38,24,receive,263179090155,11648
263179102273,26,25,receive,263179093824,8449
263179103133,84,25,receive,263179094674,8459
263179103622,28,26,receive,263179097141,6481
263179104122,88,26,receive,263179102380,1742
263179110188,12,26,receive,263179105691,4497
263179111478,50,25,receive,263179111016,462
263179113157,14,26,receive,263179111878,1279
263179115653,76,25,receive,263179114063,1590
263179116145,4,26,receive,263179115126,1019
263179121405,20,27,receive,263179116853,4552
263179128040,100,25,receive,263179126508,1532
263179133026,68,27,receive,263179132338,688
263179141864,34,26,receive,263179140588,1276
263179145616,36,26,receive,263179144551,1065
263179150101,56,26,receive,263179147340,2761
263179151717,32,25,receive,263179151016,701
263179157295,58,26,receive,263179153790,3505
263179157748,94,25,receive,263179153761,3987
263179161406,44,25,receive,263179159664,1742
263179164851,62,26,receive,263179163161,1690
263179175606,30,26,receive,263179170555,5051
263179176922,72,27,receive,263179171864,5058
263179178332,8,26,receive,263179176825,1507
263179184062,10,26,receive,263179182744,1318
263179188310,90,26,receive,263179186189,2121
263179193054,96,27,receive,263179188573,4481
263179193782,48,25,receive,263179188926,4856
263179194240,40,27,receive,263179190235,4005
263179194681,54,27,receive,263179191239,3442
263179211285,78,26,receive,263179193072,18213
263179211726,70,27,receive,263179198157,13569
263179212163,18,27,receive,263179198811,13352
263179212597,22,29,receive,263179200739,11858
263179213036,80,26,receive,263179202184,10852
263179213476,60,27,receive,263179206451,7025
263179213928,46,27,receive,263179206990,6938
263179214387,26,26,receive,263179209491,4896
263179225707,42,28,receive,263179216323,9384
263179226384,52,26,receive,263179217061,9323
263179228309,66,25,receive,263179217359,10950
263179231432,28,27,receive,263179221014,10418
263179232091,82,28,receive,263179221414,10677
263179232746,16,26,receive,263179221589,11157
263179239561,24,28,receive,263179226787,12774
263179242108,92,27,receive,263179233065,9043
263179246354,98,27,receive,263179235776,10578
263179246984,6,26,receive,263179238399,8585
263179247649,84,26,receive,263179242445,5204
263179251372,86,27,receive,263179245751,5621
263179253564,74,25,receive,263179251769,1795
263179262188,2,25,receive,263179260960,1228
263179269164,100,26,receive,263179267785,1379
263179277023,68,28,receive,263179274466,2557
263179278705,12,27,receive,263179277528,1177
263179281519,14,27,receive,263179279237,2282
263179283581,64,26,receive,263179282849,732
263179287390,38,25,receive,263179286007,1383
263179290295,88,27,receive,263179289012,1283
263179291282,30,27,receive,263179289285,1997
263179298329,56,27,receive,263179294280,4049
263179303420,48,26,receive,263179302049,1371
263179312198,8,27,receive,263179310267,1931
263179313016,10,27,receive,263179312167,849
263179318377,4,27,receive,263179313626,4751
263179320944,94,26,receive,263179318969,1975
263179321523,50,26,receive,263179320054,1469
263179322135,34,27,receive,263179320712,1423
263179336411,90,27,receive,263179321258,15153
263179337124,40,28,receive,263179323498,13626
263179337856,52,27,receive,263179329687,8169
263179338472,78,27,receive,263179329990,8482
263179339162,96,28,receive,263179331847,7315
263179339810,76,26,receive,263179332293,7517
263179352841,36,27,receive,263179336657,16184
263179353502,66,26,receive,263179337510,15992
263179359184,46,28,receive,263179337982,21202
263179359836,42,29,receive,263179338724,21112
263179360489,20,28,receive,263179345398,15091
263179373814,54,28,receive,263179348487,25327
263179374478,80,27,receive,263179346809,27669
263179375140,62,27,receive,263179352377,22763
263179375802,72,28,receive,263179358558,17244
263179376502,32,26,receive,263179365328,11174
263179385526,44,26,receive,263179369479,16047
263179386236,58,27,receive,263179370095,16141
263179386901,60,28,receive,263179368130,18771
263179392807,24,29,receive,263179377999,14808
263179393475,16,27,receive,263179380920,12555
263179396106,86,28,receive,263179383287,12819
263179399026,82,29,receive,263179384930,14096
263179402358,70,28,receive,263179387007,15351
263179402818,74,26,receive,263179396081,6737
263179403276,2,26,receive,263179399241,4035
263179405722,12,28,receive,263179399198,6524
263179410365,18,28,receive,263179407118,3247
263179412651,22,30,receive,263179407709,4942
263179413313,88,28,receive,263179409334,3979
263179424378,68,29,receive,263179415820,8558
263179425030,28,28,receive,263179416011,9019
263179425679,84,27,receive,263179419951,5728
263179426325,26,27,receive,263179421885,4440
263179437393,98,28,receive,263179427162,10231
263179438039,6,27,receive,263179428010,10029
263179438692,92,28,receive,263179429544,9148
263179439345,30,28,receive,263179435948,3397
263179442066,46,29,receive,263179441449,617
263179442639,38,26,receive,263179441484,1155
263179444418,64,27,receive,263179442663,1755
263179445087,94,27,receive,263179443207,1880
263179453136,10,28,receive,263179451493,1643
263179462249,90,28,receive,263179461115,1134
263179462910,40,29,receive,263179461167,1743
263179482402,48,27,receive,263179474343,8059
263179483067,96,29,receive,263179475441,7626
263179489360,56,28,receive,263179476806,12554
263179490038,72,29,receive,263179477077,12961
263179490665,100,27,receive,263179479080,11585
263179502970,52,28,receive,263179483184,19786
263179503928,32,27,receive,263179488832,15096
263179504587,44,27,receive,263179489042,15545
263179505243,4,28,receive,263179489721,15522
263179505888,14,28,receive,263179492109,13779
263179512304,78,28,receive,263179496073,16231
263179520099,76,27,receive,263179503092,17007
263179520528,66,27,receive,263179507812,12716
263179520951,50,27,receive,263179512386,8565
263179521403,86,29,receive,263179512507,8896
263179521848,82,30,receive,263179516273,5575
263179522302,80,28,receive,263179516756,5546
263179536596,42,30,receive,263179523015,13581
263179537250,8,28,receive,263179523575,13675
263179537917,58,28,receive,263179525829,12088
263179538539,20,29,receive,263179527983,10556
263179539199,34,28,receive,263179527942,11257
263179540664,28,29,receive,263179537612,3052
263179547249,60,29,receive,263179538961,8288
263179547899,36,28,receive,263179539444,8455
263179548554,24,30,receive,263179543179,5375
263179562242,22,31,receive,263179549409,12833
263179562896,74,27,receive,263179552745,10151
263179563547,92,29,receive,263179554348,9199
263179564197,18,29,receive,263179554506,9691
263179564844,54,29,receive,263179555496,9348
263179565489,62,28,receive,263179557390,8099
263179581076,70,29,receive,263179558461,22615
263179583462,98,29,receive,263179558605,24857
263179584119,12,29,receive,263179556439,27680
263179584769,90,29,receive,263179576715,8054
263179585423,16,28,receive,263179579706,5717
263179592937,10,29,receive,263179580917,12020
263179593593,38,27,receive,263179581076,12517
263179593970,2,27,receive,263179586610,7360
263179601116,26,28,receive,263179600078,1038
263179603288,88,29,receive,263179602075,1213
263179604619,84,28,receive,263179602397,2222
263179609206,6,28,receive,263179607346,1860
263179612679,64,28,receive,263179610277,2402
263179618668,68,30,receive,263179615235,3433
263179620029,52,29,receive,263179617450,2579
263179624895,94,28,receive,263179623844,1051
263179629890,30,29,receive,263179627114,2776
263179630560,32,28,receive,263179627020,3540
263179634239,76,28,receive,263179632285,1954
263179635949,4,29,receive,263179634207,1742
263179644350,58,29,receive,263179639548,4802
263179645417,86,30,receive,263179640174,5243
263179645956,44,28,receive,263179644217,1739
263179659050,14,29,receive,263179644646,14404
263179659704,34,29,receive,263179648189,11515
263179664292,46,30,receive,263179648321,15971
263179664807,80,29,receive,263179648339,16468
263179670916,72,30,receive,263179650509,20407
263179671571,36,29,receive,263179652735,18836
263179676245,48,28,receive,263179655205,21040
263179676900,24,31,receive,263179660007,16893
263179677553,66,28,receive,263179660609,16944
263179678209,100,28,receive,263179660683,17526
263179678860,96,30,receive,263179665120,13740
263179679518,78,29,receive,263179665565,13953
263179706330,40,30,receive,263179665923,40407
263179706976,18,30,receive,263179679940,27036
263179707630,56,29,receive,263179685124,22506
263179708282,70,30,receive,263179685022,23260
263179708931,28,30,receive,263179686795,22136
263179709590,60,30,receive,263179692558,17032
263179727309,38,28,receive,263179695605,31704
263179727957,12,30,receive,263179697087,30870
263179728609,10,30,receive,263179705835,22774
263179729229,20,30,receive,263179711272,17957
263179729753,74,28,receive,263179711854,17899
263179730328,92,30,receive,263179717011,13317
263179748264,6,29,receive,263179721008,27256
263179748919,26,29,receive,263179723261,25658
263179749580,90,30,receive,263179723506,26074
263179750233,82,31,receive,263179725013,25220
263179750891,8,29,receive,263179730568,20323
263179751557,42,31,receive,263179730756,20801
263179769431,50,28,receive,263179733726,35705
263179770114,52,30,receive,263179741069,29045
263179770774,68,31,receive,263179755635,15139
263179771439,62,29,receive,263179758136,13303
263179772107,64,29,receive,263179760097,12010
263179772766,22,32,receive,263179762742,10024
263179789441,98,30,receive,263179764320,25121
263179790098,100,29,receive,263179764899,25199
263179790742,94,29,receive,263179765295,25447
263179791403,84,29,receive,263179766512,24891
263179799546,34,30,receive,263179768947,30599
263179809809,88,30,receive,263179777012,32797
263179810744,54,30,receive,263179777497,33247
263179811406,32,29,receive,263179791322,20084
263179812066,24,32,receive,263179794623,17443
263179812722,16,29,receive,263179798085,14637
263179831518,46,31,receive,263179800586,30932
263179832192,80,30,receive,263179801551,30641
263179832872,44,29,receive,263179800980,31892
263179834470,2,28,receive,263179780025,54445
263179835086,18,31,receive,263179805063,30023
263179851399,14,30,receive,263179809013,42386
263179851957,28,31,receive,263179810230,41727
263179852494,12,31,receive,263179816238,36256
263179853052,10,31,receive,263179816802,36250
263179853748,48,29,receive,263179819006,34742
263179854428,86,31,receive,263179823013,31415
263179872086,56,30,receive,263179826963,45123
263179872622,72,31,receive,263179826905,45717
263179874035,58,30,receive,263179835190,38845
263179874567,76,29,receive,263179835011,39556
263179875100,60,31,receive,263179817248,57852
263179875618,40,31,receive,263179840079,35539
263179889326,4,30,receive,263179840318,49008
263179889913,66,29,receive,263179841840,48073
263179890824,30,30,receive,263179844870,45954
263179891372,26,30,receive,263179846284,45088
263179891902,38,29,receive,263179849352,42550
263179892434,90,31,receive,263179855757,36677
263179910575,50,29,receive,263179857071,53504
263179911131,36,30,receive,263179858063,53068
263179911681,78,30,receive,263179862379,49302
263179912202,70,31,receive,263179864127,48075
263179912710,20,31,receive,263179869176,43534
263179913271,96,31,receive,263179873021,40250
263179913943,6,30,receive,263179881006,32937
263179928642,52,31,receive,263179881327,47315
263179929324,54,31,receive,263179887495,41829
263179930009,68,32,receive,263179890092,39917
263179930599,98,31,receive,263179892446,38153
263179945831,82,32,receive,263179894379,51452
263179946519,64,30,receive,263179889013,57506
263179947081,8,30,receive,263179900074,47007
263179947594,92,31,receive,263179909818,37776
263179948135,74,29,receive,263179916843,31292
263179948671,12,32,receive,263179923343,25328
263179971734,22,33,receive,263179925604,46130
263179972423,80,31,receive,263179935303,37120
263179973114,62,30,receive,263179935755,37359
263179973792,48,30,receive,263179939245,34547
263179981344,42,32,receive,263179930319,51025
263179993526,14,31,receive,263179949069,44457
263179994208,58,31,receive,263179949202,45006
263179994963,44,30,receive,263179950177,44786
263179995649,94,30,receive,263179961384,34265
263179996344,72,32,receive,263179967689,28655
263180016035,88,31,receive,263179968919,47116
263180016689,18,32,receive,263179969563,47126
263180017204,10,32,receive,263179969789,47415
263180017716,84,30,receive,263179974066,43650
263180018231,100,30,receive,263179974018,44213
263180018760,34,31,receive,263179977026,41734
263180037691,20,32,receive,263179977443,60248
263180038408,86,32,receive,263179978431,59977
263180040440,46,32,receive,263179981616,58824
263180041074,66,30,receive,263179983439,57635
263180041649,32,30,receive,263179984466,57183
