receive_timestamp,source_vehicle,message_id,event_type,send_timestamp,latency_us
373450087,104,3,receive,373300144,149943
373450547,98,2,receive,373301015,149532
373450963,152,3,receive,373301213,149750
373451352,384,1,receive,373301901,149451
373451750,86,2,receive,373303095,148655
373452146,448,1,receive,373303372,148774
373452535,486,1,receive,373304542,147993
373452952,42,3,receive,373242320,210632
373453350,426,1,receive,373306585,146765
373453778,160,2,receive,373306687,147091
373454233,634,1,receive,373308105,146128
373454662,408,1,receive,373308867,145795
373455077,870,1,receive,373309486,145591
373455490,210,1,receive,373310039,145451
373455903,26,4,receive,373245006,210897
373456317,114,4,receive,373311673,144644
373456759,64,3,receive,373282318,174441
373457175,30,1,receive,373312619,144556
373457589,196,4,receive,373313394,144195
373458002,408,2,receive,373314436,143566
373458414,974,2,receive,373314787,143627
373459758,140,2,receive,373316070,143688
373870760,104,4,receive,373316474,554286
373871198,184,4,receive,373316662,554536
373871645,166,1,receive,373316885,554760
373872082,128,4,receive,373317077,555005
373872536,50,1,receive,373318434,554102
373873002,790,1,receive,373318464,554538
373873528,798,1,receive,373318566,554962
373873998,196,5,receive,373318774,555224
373874450,54,1,receive,373318997,555453
374079499,18,2,receive,373320016,759483
374080048,202,3,receive,373294291,785757
374081588,80,1,receive,373322157,759431
374082194,86,3,receive,373322441,759753
374082862,400,1,receive,373323456,759406
374083435,122,1,receive,373296841,786594
374084013,158,1,receive,373304081,779932
374084496,230,2,receive,373326675,757821
374085024,320,2,receive,373327062,757962
374310797,98,3,receive,373323391,987406
374311261,384,2,receive,373330017,981244
374311705,252,1,receive,373331018,980687
374312199,634,2,receive,373331441,980758
374312641,632,1,receive,373332263,980378
374313110,118,1,receive,373332253,980857
374313568,6,4,receive,373278304,1035264
374314051,90,3,receive,373332855,981196
374314511,818,1,receive,373332891,981620
374314962,90,4,receive,373333221,981741
374539472,400,2,receive,373333307,1206165
374539944,150,3,receive,373334297,1205647
374540421,44,5,receive,373273715,1266706
374540876,154,2,receive,373334689,1206187
374541354,486,2,receive,373334774,1206580
374541824,758,1,receive,373334743,1207081
374542334,182,3,receive,373296292,1246042
374542792,206,2,receive,373335639,1207153
374543253,972,1,receive,373336349,1206904
374543736,798,2,receive,373336605,1207131
374752170,728,1,receive,373337175,1414995
374752648,152,4,receive,373321810,1430838
374753169,58,4,receive,373280331,1472838
374753639,670,1,receive,373337448,1416191
374754137,132,1,receive,373337427,1416710
374754608,766,1,receive,373337608,1417000
374755098,84,3,receive,373324172,1430926
374755568,312,1,receive,373339142,1416426
374756050,312,2,receive,373339616,1416434
374960823,100,1,receive,373257727,1703096
374961346,96,3,receive,373340772,1620574
374961810,274,1,receive,373342284,1619526
374962324,188,2,receive,373340656,1621668
374962798,204,1,receive,373342449,1620349
374963263,426,2,receive,373343822,1619441
374963721,408,3,receive,373344177,1619544
374964175,338,1,receive,373344313,1619862
374964650,18,3,receive,373343300,1621350
374965147,12,5,receive,373315677,1649470
375212096,138,1,receive,373345262,1866834
375212557,626,1,receive,373345494,1867063
375213092,110,3,receive,373345744,1867348
375213606,590,5,receive,373345797,1867809
375214102,782,1,receive,373346124,1867978
375214608,160,3,receive,373346421,1868187
375215100,290,1,receive,373311159,1903941
375215682,964,1,receive,373346825,1868857
375216067,96,4,receive,373346856,1869211
375216522,432,2,receive,373347684,1868838
375455216,670,2,receive,373349026,2106190
375455688,632,2,receive,373350024,2105664
375456153,106,3,receive,373351343,2104810
375456630,708,1,receive,373351772,2104858
375457096,158,2,receive,373351916,2105180
375457561,150,4,receive,373352784,2104777
375458026,284,1,receive,373353815,2104211
375458521,70,5,receive,373288342,2170179
375458991,426,3,receive,373354781,2104210
375459479,868,2,receive,373354805,2104674
375711131,730,1,receive,373355393,2355738
375711673,206,3,receive,373355353,2356320
375712141,1000,1,receive,373355649,2356492
375712611,382,1,receive,373356097,2356514
375713079,320,3,receive,373357048,2356031
375713598,80,2,receive,373357455,2356143
375714062,36,2,receive,373357977,2356085
375714529,56,3,receive,373241375,2473154
375715027,490,1,receive,373358269,2356758
375715497,400,3,receive,373358854,2356643
375964505,554,1,receive,373359320,2605185
375964992,598,1,receive,373359649,2605343
375965450,212,1,receive,373360429,2605021
375965905,104,5,receive,373360476,2605429
375966402,818,2,receive,373360893,2605509
375966858,128,5,receive,373361359,2605499
375967322,190,1,receive,373362713,2604609
375967777,764,1,receive,373362713,2605064
375968245,210,2,receive,373363083,2605162
375968723,230,3,receive,373364522,2604201
376207601,778,4,receive,373364429,2843172
376208003,592,1,receive,373364608,2843395
376208416,488,1,receive,373367149,2841267
376208825,426,4,receive,373367583,2841242
376209222,332,1,receive,373367726,2841496
376209613,354,1,receive,373368455,2841158
376210030,582,1,receive,373368957,2841073
376210642,114,5,receive,373368894,2841748
376211009,86,4,receive,373369044,2841965
376211494,640,1,receive,373369448,2842046
376211925,166,2,receive,373358761,2853164
376450934,300,1,receive,373370044,3080890
376451336,192,1,receive,373370182,3081154
376451749,712,1,receive,373370313,3081436
376452156,486,3,receive,373371338,3080818
376452551,130,3,receive,373309045,3143506
376452942,524,1,receive,373374149,3078793
376453359,130,4,receive,373373933,3079426
376453789,530,1,receive,373374600,3079189
376454196,436,1,receive,373374829,3079367
376454595,130,5,receive,373375029,3079566
376454990,636,2,receive,373376013,3078977
376455388,90,5,receive,373376866,3078522
376696442,508,1,receive,373376887,3319555
376696962,130,6,receive,373376476,3320486
376697429,972,2,receive,373377276,3320153
376697909,426,5,receive,373377644,3320265
376698379,634,3,receive,373378345,3320034
376698872,918,1,receive,373378463,3320409
376699341,618,1,receive,373379066,3320275
376699948,166,3,receive,373380013,3319935
376700426,112,2,receive,373285041,3415385
376925271,196,6,receive,373381922,3543349
376925742,868,3,receive,373382063,3543679
376926192,8,5,receive,373278178,3648014
376926651,90,6,receive,373382316,3544335
376927087,400,4,receive,373382781,3544306
376927525,340,1,receive,373296934,3630591
376927960,486,4,receive,373383975,3543985
376928422,432,3,receive,373383008,3545414
376928884,126,2,receive,373305048,3623836
376929333,222,1,receive,373375932,3553401
377159514,316,1,receive,373386209,3773305
377159990,486,5,receive,373386787,3773203
377160453,730,2,receive,373387278,3773175
377160920,2,5,receive,373273391,3887529
377161360,154,3,receive,373388709,3772651
377161807,734,1,receive,373389539,3772268
377162248,444,1,receive,373334200,3828048
377162699,436,2,receive,373390018,3772681
377163135,638,1,receive,373371725,3791410
377163567,492,2,receive,373390020,3773547
377395892,618,2,receive,373390437,4005455
377396397,366,1,receive,373390145,4006252
377396857,62,4,receive,373250337,4146520
377397297,774,1,receive,373390624,4006673
377397758,756,1,receive,373390885,4006873
377398194,554,2,receive,373391272,4006922
377398626,196,7,receive,373391318,4007308
377399065,678,1,receive,373391717,4007348
377399523,964,2,receive,373391772,4007751
377399974,724,1,receive,373392160,4007814
377636020,64,4,receive,373354344,4281676
377636493,488,2,receive,373393759,4242734
377636945,798,3,receive,373393968,4242977
377637396,320,4,receive,373394395,4243001
377637856,222,2,receive,373395466,4242390
377638309,778,5,receive,373395541,4242768
377638754,778,6,receive,373395881,4242873
377639204,32,3,receive,373285087,4354117
377639662,206,4,receive,373396720,4242942
377640141,336,1,receive,373396941,4243200
377870271,2,6,receive,373393761,4476510
377870741,766,2,receive,373397603,4473138
377871272,352,1,receive,373355333,4515939
377871729,164,2,receive,373287511,4584218
377872173,434,1,receive,373398867,4473306
377872645,804,1,receive,373398932,4473713
377873093,456,2,receive,373399942,4473151
377873519,858,1,receive,373343766,4529753
377873950,612,2,receive,373391742,4482208
377874392,150,5,receive,373400589,4473803
378100871,560,1,receive,373401198,4699673
378101325,330,1,receive,373400981,4700344
378101771,204,2,receive,373401651,4700120
378102213,564,1,receive,373401672,4700541
378102676,222,3,receive,373402437,4700239
378103136,778,7,receive,373402673,4700463
378103579,230,4,receive,373403215,4700364
378104027,586,1,receive,373403229,4700798
378104494,670,3,receive,373403888,4700606
378104970,982,1,receive,373404064,4700906
378332074,592,2,receive,373404299,4927775
378332549,554,3,receive,373404704,4927845
