receive_timestamp,source_vehicle,message_id,event_type,send_timestamp,latency_us
373386624,38,3,receive,373241428,145196
373387212,184,2,receive,373252728,134484
373387894,82,1,receive,373253177,134717
373388479,72,3,receive,373236969,151510
373389077,156,2,receive,373254574,134503
373389507,8,3,receive,373254823,134684
373768714,126,1,receive,373255577,513137
373769172,40,3,receive,373255919,513253
373769606,74,4,receive,373256025,513581
373770061,6,3,receive,373245051,525010
373770513,168,1,receive,373256251,514262
373770963,128,2,receive,373258107,512856
373771400,186,2,receive,373259077,512323
373771842,4,4,receive,373258886,512956
373772288,12,3,receive,373259914,512374
373954939,32,2,receive,373250011,704928
373955407,92,1,receive,373260118,695289
373955862,104,1,receive,373260181,695681
373956312,114,2,receive,373260429,695883
373956778,172,1,receive,373260499,696279
373957245,66,6,receive,373256207,701038
373957699,144,1,receive,373260632,697067
373958148,8,4,receive,373257755,700393
373958620,112,1,receive,373262148,696472
373959084,40,4,receive,373262494,696590
374214718,206,1,receive,373262711,952007
374215185,96,1,receive,373262913,952272
374215628,150,1,receive,373264523,951105
374216094,208,2,receive,373264969,951125
374216539,14,6,receive,373264854,951685
374216982,590,1,receive,373266097,950885
374217439,14,7,receive,373267806,949633
374217887,140,1,receive,373270021,947866
374218332,22,1,receive,373270029,948303
374218786,18,1,receive,373270036,948750
374458409,202,2,receive,373270712,1187697
374458898,60,1,receive,373270683,1188215
374459360,160,1,receive,373270910,1188450
374459837,20,4,receive,373261219,1198618
374460342,590,2,receive,373272425,1187917
374460823,172,2,receive,373273789,1187034
374461281,128,3,receive,373275202,1186079
374461851,456,1,receive,373276083,1185768
374462400,196,2,receive,373276902,1185498
374678784,188,1,receive,373276852,1401932
374679270,110,2,receive,373277086,1402184
374679759,184,3,receive,373277380,1402379
374680242,162,1,receive,373277349,1402893
374680747,20,5,receive,373276963,1403784
374681209,12,4,receive,373278229,1402980
374681689,164,1,receive,373272121,1409568
374682172,394,1,receive,373278752,1403420
374682637,82,2,receive,373266117,1416520
374683117,34,5,receive,373244407,1438710
374954852,40,5,receive,373278855,1675997
374955333,230,1,receive,373279031,1676302
374955798,492,1,receive,373279049,1676749
374956457,570,1,receive,373279141,1677316
374956921,36,1,receive,373280391,1676530
374957555,152,2,receive,373281154,1676401
374957991,88,2,receive,373263989,1694002
374958450,52,3,receive,373248117,1710333
374958890,154,1,receive,373286200,1672690
375194673,186,3,receive,373272645,1922028
375195140,196,3,receive,373287096,1908044
375195613,114,3,receive,373287285,1908328
375196069,96,2,receive,373287418,1908651
375196526,76,3,receive,373251724,1944802
375196982,590,3,receive,373289408,1907574
375197450,636,1,receive,373289341,1908109
375197937,778,1,receive,373289648,1908289
375198398,86,1,receive,373290793,1907605
375198865,98,1,receive,373291041,1907824
375452041,868,1,receive,373291114,2160927
375452502,590,4,receive,373292667,2159835
375452972,104,2,receive,373292892,2160080
375453585,90,2,receive,373293038,2160547
375454053,778,2,receive,373293094,2160959
375454575,432,1,receive,373294811,2159764
375455050,68,1,receive,373294917,2160133
375455671,346,1,receive,373295462,2160209
375456173,320,1,receive,373296620,2159553
375669037,108,2,receive,373288603,2380434
375669527,84,1,receive,373282609,2386918
375669988,84,2,receive,373297268,2372720
375670473,302,1,receive,373297189,2373284
375670938,612,1,receive,373297315,2373623
375671377,150,2,receive,373297382,2373995
375671819,974,1,receive,373292613,2379206
375672295,674,1,receive,373297959,2374336
375672802,106,2,receive,373298141,2374661
375673269,778,3,receive,373298369,2374900
375907853,104,3,receive,373300144,2607709
375908285,98,2,receive,373301015,2607270
375908735,152,3,receive,373301213,2607522
375909295,384,1,receive,373301901,2607394
375909758,86,2,receive,373303095,2606663
375910236,448,1,receive,373303372,2606864
375910705,486,1,receive,373304542,2606163
375911190,42,3,receive,373242320,2668870
375911646,426,1,receive,373306585,2605061
375912103,160,2,receive,373306687,2605416
376134406,634,1,receive,373308105,2826301
376134872,408,1,receive,373308867,2826005
376135328,870,1,receive,373309486,2825842
376135797,210,1,receive,373310039,2825758
376136271,26,4,receive,373245006,2891265
376136751,114,4,receive,373311673,2825078
376137217,64,3,receive,373282318,2854899
376137696,30,1,receive,373312619,2825077
376138166,196,4,receive,373313394,2824772
376138632,408,2,receive,373314436,2824196
376386330,974,2,receive,373314787,3071543
376386784,140,2,receive,373316070,3070714
376387244,104,4,receive,373316474,3070770
376387696,184,4,receive,373316662,3071034
376388159,166,1,receive,373316885,3071274
376388612,128,4,receive,373317077,3071535
376389081,790,1,receive,373318464,3070617
376389561,798,1,receive,373318566,3070995
376390033,50,1,receive,373318434,3071599
376390497,196,5,receive,373318774,3071723
376641594,54,1,receive,373318997,3322597
376642080,18,2,receive,373320016,3322064
376642545,202,3,receive,373294291,3348254
376643010,80,1,receive,373322157,3320853
376643480,86,3,receive,373322441,3321039
376643962,400,1,receive,373323456,3320506
376644428,122,1,receive,373296841,3347587
376644895,158,1,receive,373304081,3340814
376645361,230,2,receive,373326675,3318686
376645841,320,2,receive,373327062,3318779
376879292,98,3,receive,373323391,3555901
376879764,384,2,receive,373330017,3549747
376880252,252,1,receive,373331018,3549234
376880730,634,2,receive,373331441,3549289
376881214,632,1,receive,373332263,3548951
376881685,118,1,receive,373332253,3549432
376882152,6,4,receive,373278304,3603848
376882621,90,3,receive,373332855,3549766
376883122,818,1,receive,373332891,3550231
377086133,90,4,receive,373333221,3752912
377086584,400,2,receive,373333307,3753277
377087026,150,3,receive,373334297,3752729
377087485,44,5,receive,373273715,3813770
377087931,154,2,receive,373334689,3753242
377088376,486,2,receive,373334774,3753602
377088817,758,1,receive,373334743,3754074
377089281,182,3,receive,373296292,3792989
377089736,206,2,receive,373335639,3754097
377090193,972,1,receive,373336349,3753844
377328938,798,2,receive,373336605,3992333
377329389,728,1,receive,373337175,3992214
377329839,152,4,receive,373321810,4008029
377330296,58,4,receive,373280331,4049965
377330759,670,1,receive,373337448,3993311
377331206,132,1,receive,373337427,3993779
377331650,766,1,receive,373337608,3994042
377332095,84,3,receive,373324172,4007923
377332560,312,1,receive,373339142,3993418
377333012,312,2,receive,373339616,3993396
377559714,100,1,receive,373257727,4301987
377560197,96,3,receive,373340772,4219425
377560652,274,1,receive,373342284,4218368
377561106,204,1,receive,373342449,4218657
377561557,188,2,receive,373340656,4220901
377562021,426,2,receive,373343822,4218199
377562473,408,3,receive,373344177,4218296
377562929,338,1,receive,373344313,4218616
377563374,18,3,receive,373343300,4220074
377563828,12,5,receive,373315677,4248151
377787698,138,1,receive,373345262,4442436
377788178,626,1,receive,373345494,4442684
377788634,110,3,receive,373345744,4442890
377789098,590,5,receive,373345797,4443301
377789537,782,1,receive,373346124,4443413
377790016,160,3,receive,373346421,4443595
377790462,290,1,receive,373311159,4479303
378076080,964,1,receive,373346825,4729255
378076558,96,4,receive,373346856,4729702
378077038,432,2,receive,373347684,4729354
378077487,670,2,receive,373349026,4728461
378077950,632,2,receive,373350024,4727926
378078430,106,3,receive,373351343,4727087
378078904,708,1,receive,373351772,4727132
378079386,158,2,receive,373351916,4727470
378079920,150,4,receive,373352784,4727136
378294749,284,1,receive,373353815,4940934
378295214,70,5,receive,373288342,5006872
378295662,868,2,receive,373354805,4940857
378296109,426,3,receive,373354781,4941328
378296566,730,1,receive,373355393,4941173
378297006,206,3,receive,373355353,4941653
378297466,1000,1,receive,373355649,4941817
378297902,382,1,receive,373356097,4941805
378298345,320,3,receive,373357048,4941297
378298807,80,2,receive,373357455,4941352
378480330,36,2,receive,373357977,5122353
378480743,56,3,receive,373241375,5239368
378481117,490,1,receive,373358269,5122848
378481555,400,3,receive,373358854,5122701
378481973,554,1,receive,373359320,5122653
378482479,598,1,receive,373359649,5122830
378482862,104,5,receive,373360476,5122386
378483297,212,1,receive,373360429,5122868
378483731,818,2,receive,373360893,5122838
378484148,128,5,receive,373361359,5122789
378484614,190,1,receive,373362713,5121901
378668131,764,1,receive,373362713,5305418
378668607,210,2,receive,373363083,5305524
378669003,230,3,receive,373364522,5304481
378669395,778,4,receive,373364429,5304966
378669793,592,1,receive,373364608,5305185
378670263,488,1,receive,373367149,5303114
378670655,426,4,receive,373367583,5303072
378671065,332,1,receive,373367726,5303339
378671460,354,1,receive,373368455,5303005
378671880,582,1,receive,373368957,5302923
378672287,114,5,receive,373368894,5303393
378851294,86,4,receive,373369044,5482250
378851698,640,1,receive,373369448,5482250
378852123,166,2,receive,373358761,5493362
378852505,300,1,receive,373370044,5482461
378852893,192,1,receive,373370182,5482711
378853352,712,1,receive,373370313,5483039
378853779,486,3,receive,373371338,5482441
378854197,130,3,receive,373309045,5545152
378854776,524,1,receive,373374149,5480627
378855462,130,4,receive,373373933,5481529
379019179,530,1,receive,373374600,5644579
379019638,436,1,receive,373374829,5644809
379020110,130,5,receive,373375029,5645081
379020583,636,2,receive,373376013,5644570
379021055,90,5,receive,373376866,5644189
379021517,508,1,receive,373376887,5644630
379021984,130,6,receive,373376476,5645508
379022460,972,2,receive,373377276,5645184
379022921,426,5,receive,373377644,5645277
379188965,634,3,receive,373378345,5810620
379189461,918,1,receive,373378463,5810998
379189921,618,1,receive,373379066,5810855
379190388,166,3,receive,373380013,5810375
379190854,112,2,receive,373285041,5905813
379191401,196,6,receive,373381922,5809479
379191854,868,3,receive,373382063,5809791
379192317,8,5,receive,373278178,5914139
379192763,90,6,receive,373382316,5810447
379357055,400,4,receive,373382781,5974274
379357539,340,1,receive,373296934,6060605
379358014,486,4,receive,373383975,5974039
379358483,432,3,receive,373383008,5975475
379358948,126,2,receive,373305048,6053900
379359458,222,1,receive,373375932,5983526
379359985,316,1,receive,373386209,5973776
379360458,486,5,receive,373386787,5973671
379360918,730,2,receive,373387278,5973640
379361380,2,5,receive,373273391,6087989
379512306,154,3,receive,373388709,6123597
379512786,734,1,receive,373389539,6123247
379513242,444,1,receive,373334200,6179042
379513706,436,2,receive,373390018,6123688
379514209,638,1,receive,373371725,6142484
379514683,492,2,receive,373390020,6124663
379515163,366,1,receive,373390145,6125018
379515623,618,2,receive,373390437,6125186
379516086,62,4,receive,373250337,6265749
379516570,774,1,receive,373390624,6125946
379681665,756,1,receive,373390885,6290780
379682132,554,2,receive,373391272,6290860
379682528,196,7,receive,373391318,6291210
379682955,678,1,receive,373391717,6291238
379683395,964,2,receive,373391772,6291623
379683827,724,1,receive,373392160,6291667
379684234,64,4,receive,373354344,6329890
379684620,488,2,receive,373393759,6290861
379685057,798,3,receive,373393968,6291089
379685511,320,4,receive,373394395,6291116
379685964,222,2,receive,373395466,6290498
379834708,778,5,receive,373395541,6439167
379835139,778,6,receive,373395881,6439258
379835600,32,3,receive,373285087,6550513
379836066,206,4,receive,373396720,6439346
379836513,336,1,receive,373396941,6439572
379836959,2,6,receive,373393761,6443198
379837402,766,2,receive,373397603,6439799
379837844,352,1,receive,373355333,6482511
379838301,164,2,receive,373287511,6550790
379838776,434,1,receive,373398867,6439909
379983421,804,1,receive,373398932,6584489
379983938,456,2,receive,373399942,6583996
379984436,858,1,receive,373343766,6640670
379984907,612,2,receive,373391742,6593165
379985495,150,5,receive,373400589,6584906
379985965,560,1,receive,373401198,6584767
379986442,330,1,receive,373400981,6585461
379986891,204,2,receive,373401651,6585240
379987362,564,1,receive,373401672,6585690
380132740,222,3,receive,373402437,6730303
380133208,778,7,receive,373402673,6730535
380133678,230,4,receive,373403215,6730463
380134152,586,1,receive,373403229,6730923
380134613,670,3,receive,373403888,6730725
380135069,982,1,receive,373404064,6731005
380135526,592,2,receive,373404299,6731227
380135991,554,3,receive,373404704,6731287
380136450,994,1,receive,373404655,6731795
380273136,634,4,receive,373405133,6868003
380273692,634,5,receive,373405599,6868093
