receive_timestamp,source_vehicle,message_id,event_type,send_timestamp,latency_us
18841306034,92,1,receive,18841300736,5298
18841306844,158,1,receive,18841301775,5069
18841307597,34,1,receive,18841301960,5637
18841308485,130,1,receive,18841302267,6218
18841309196,52,1,receive,18841302493,6703
18841600021,28,1,receive,18841302785,297236
18841600345,20,1,receive,18841302921,297424
18841600691,80,1,receive,18841303103,297588
18841601015,36,1,receive,18841304421,296594
18841601331,140,1,receive,18841304658,296673
18841601648,98,1,receive,18841305340,296308
18841602039,154,1,receive,18841309047,292992
18841602457,42,1,receive,18841310243,292214
18841602819,120,1,receive,18841311208,291611
18841603169,54,1,receive,18841311456,291713
18841603511,56,1,receive,18841311654,291857
18841603950,26,1,receive,18841312773,291177
18841604301,86,2,receive,18841317062,287239
18841604630,76,1,receive,18841318245,286385
18841604958,40,1,receive,18841319217,285741
18841605283,140,2,receive,18841322159,283124
18841605611,84,1,receive,18841323743,281868
18841605978,66,1,receive,18841324019,281959
18841606319,70,1,receive,18841326788,279531
18841606671,70,2,receive,18841327272,279399
18841607012,34,2,receive,18841328992,278020
18841607379,100,1,receive,18841329814,277565
18841607742,136,1,receive,18841330056,277686
18841608160,126,1,receive,18841330084,278076
18841608515,96,1,receive,18841331263,277252
18841608920,96,2,receive,18841331899,277021
18841609321,140,3,receive,18841332856,276465
18841609658,102,1,receive,18841332884,276774
18841770034,122,1,receive,18841333860,436174
18841770612,76,2,receive,18841334009,436603
18841770935,120,2,receive,18841334414,436521
18841771395,118,1,receive,18841335105,436290
18841771746,118,2,receive,18841335873,435873
18841772137,140,4,receive,18841337258,434879
18841772469,138,1,receive,18841338523,433946
18841772799,120,3,receive,18841338815,433984
18841773268,56,2,receive,18841339254,434014
18841773635,28,2,receive,18841340023,433612
18841774070,80,2,receive,18841341130,432940
18841774401,6,1,receive,18841341213,433188
18841890206,34,3,receive,18841341509,548697
18841890536,86,3,receive,18841341639,548897
18841890872,38,1,receive,18841341795,549077
18841891186,86,4,receive,18841342029,549157
18841891523,118,3,receive,18841342899,548624
18841891849,140,5,receive,18841345630,546219
18841892168,76,3,receive,18841345913,546255
18841892482,64,1,receive,18841346302,546180
18841892814,10,1,receive,18841346504,546310
18841893137,92,2,receive,18841347742,545395
18841893523,52,2,receive,18841348572,544951
18841893873,140,6,receive,18841348951,544922
18841894198,142,1,receive,18841349378,544820
18841894527,54,2,receive,18841349713,544814
18841894849,120,4,receive,18841350221,544628
18841895170,16,1,receive,18841352218,542952
18841895597,48,1,receive,18841352766,542831
18841895924,8,1,receive,18841353060,542864
18841896237,110,1,receive,18841353267,542970
18841896550,86,5,receive,18841353353,543197
18841896865,158,2,receive,18841354631,542234
18841897178,50,1,receive,18841354700,542478
18841897586,36,2,receive,18841354783,542803
18841897915,154,2,receive,18841355166,542749
18841898300,76,4,receive,18841355306,542994
18841898639,156,1,receive,18841356683,541956
18842128029,20,2,receive,18841357182,770847
18842128344,40,2,receive,18841357689,770655
18842128648,24,1,receive,18841357913,770735
18842128946,192,1,receive,18841358295,770651
18842129251,26,2,receive,18841359280,769971
18842129552,66,2,receive,18841359433,770119
18842129938,30,1,receive,18841360804,769134
18842130337,150,1,receive,18841360895,769442
18842130731,96,3,receive,18841361211,769520
18842131081,132,1,receive,18841361305,769776
18842131410,42,2,receive,18841362809,768601
18842131765,46,1,receive,18841362920,768845
18842132096,114,1,receive,18841364200,767896
18842132464,88,1,receive,18841364557,767907
18842132832,20,3,receive,18841365456,767376
18842133161,96,4,receive,18841365704,767457
18842133500,84,2,receive,18841366799,766701
18842133913,40,3,receive,18841366904,767009
18842134361,120,5,receive,18841367514,766847
18842134698,136,2,receive,18841367664,767034
18842135035,2,1,receive,18841369372,765663
18842135359,80,3,receive,18841369642,765717
18842135724,34,4,receive,18841370016,765708
18842136072,112,1,receive,18841370738,765334
18842136420,78,1,receive,18841372617,763803
18842136763,104,1,receive,18841373015,763748
18842137104,98,2,receive,18841373202,763902
18842137442,184,1,receive,18841373484,763958
18842137843,180,1,receive,18841374003,763840
18842138194,86,6,receive,18841374688,763506
18842138534,60,1,receive,18841375025,763509
18842138901,12,1,receive,18841375431,763470
18842139266,128,1,receive,18841376126,763140
18842139648,136,3,receive,18841376934,762714
18842310067,80,4,receive,18841377901,932166
18842310473,154,3,receive,18841378095,932378
18842310836,126,2,receive,18841378314,932522
18842311246,192,2,receive,18841378700,932546
18842311566,190,1,receive,18841380050,931516
18842311965,124,1,receive,18841380566,931399
18842312297,6,2,receive,18841380910,931387
18842312663,28,3,receive,18841381006,931657
18842312986,146,1,receive,18841381406,931580
18842313355,166,1,receive,18841381576,931779
18842313673,144,1,receive,18841381709,931964
18842314142,62,1,receive,18841382102,932040
18842315204,134,1,receive,18841382195,933009
18842353655,140,7,receive,18841382284,971371
18842354044,164,1,receive,18841382545,971499
18842354439,36,3,receive,18841383315,971124
18842354779,76,5,receive,18841383766,971013
18842355224,76,6,receive,18841383973,971251
18842355578,106,1,receive,18841384342,971236
18842356008,38,2,receive,18841384942,971066
18842356422,102,2,receive,18841385390,971032
18842356829,122,2,receive,18841385759,971070
18842357185,188,1,receive,18841385938,971247
18842357583,92,3,receive,18841386262,971321
18842357915,170,1,receive,18841388448,969467
18842358276,52,3,receive,18841389199,969077
18842358595,6,3,receive,18841390009,968586
18842359033,152,1,receive,18841390024,969009
18842406677,28,4,receive,18841391342,1015335
18842407060,156,2,receive,18841392769,1014291
18842407440,168,1,receive,18841393182,1014258
18842407803,14,1,receive,18841394788,1013015
18842408163,56,3,receive,18841394879,1013284
18842408524,154,4,receive,18841395438,1013086
18842408969,6,4,receive,18841396300,1012669
18842409342,86,7,receive,18841396895,1012447
18842409711,54,3,receive,18841397175,1012536
18842410092,126,3,receive,18841398254,1011838
18842410469,156,3,receive,18841398552,1011917
18842410904,120,6,receive,18841398863,1012041
18842411271,36,4,receive,18841399133,1012138
18842460149,42,3,receive,18841399372,1060777
18842460583,70,3,receive,18841399851,1060732
18842460962,48,2,receive,18841400154,1060808
18842461386,118,4,receive,18841400269,1061117
18842461760,158,3,receive,18841402023,1059737
18842462135,178,1,receive,18841402480,1059655
18842462533,70,4,receive,18841404117,1058416
18842462923,84,3,receive,18841404244,1058679
18842463314,146,2,receive,18841404704,1058610
18842463718,138,2,receive,18841405178,1058540
18842464305,26,3,receive,18841405602,1058703
18842464754,120,7,receive,18841406062,1058692
18842515052,76,7,receive,18841406334,1108718
18842515437,80,5,receive,18841407310,1108127
18842515803,136,4,receive,18841408450,1107353
18842516167,118,5,receive,18841409639,1106528
18842516642,74,1,receive,18841409941,1106701
18842517009,34,5,receive,18841409983,1107026
18842517374,192,3,receive,18841410163,1107211
18842517741,40,4,receive,18841410392,1107349
18842518103,122,3,receive,18841410490,1107613
18842518595,142,2,receive,18841410654,1107941
18842518974,86,8,receive,18841411176,1107798
18842519348,6,5,receive,18841411424,1107924
18842519714,144,2,receive,18841411857,1107857
18842520107,16,2,receive,18841412216,1107891
18842563238,180,2,receive,18841412571,1150667
18842563635,150,2,receive,18841412613,1151022
18842564012,94,1,receive,18841412614,1151398
18842564385,64,2,receive,18841413663,1150722
18842564755,126,4,receive,18841415105,1149650
18842565167,38,3,receive,18841415464,1149703
18842565538,96,5,receive,18841415720,1149818
18842565908,194,1,receive,18841415814,1150094
18842566282,200,1,receive,18841415786,1150496
18842566653,98,3,receive,18841416110,1150543
18842567094,158,4,receive,18841416244,1150850
18842567496,114,2,receive,18841417053,1150443
18842606847,66,3,receive,18841417220,1189627
18842607278,46,2,receive,18841417578,1189700
18842607654,120,8,receive,18841418274,1189380
18842608033,36,5,receive,18841418363,1189670
18842608409,136,5,receive,18841418779,1189630
18842608857,46,3,receive,18841419594,1189263
18842609251,56,4,receive,18841419746,1189505
18842609632,122,4,receive,18841419853,1189779
18842610109,188,2,receive,18841420914,1189195
18842610570,162,1,receive,18841420931,1189639
18842611023,152,2,receive,18841421553,1189470
18842654335,52,4,receive,18841421620,1232715
18842654717,102,3,receive,18841422110,1232607
18842655115,76,8,receive,18841422313,1232802
18842655498,26,4,receive,18841423914,1231584
18842655862,176,1,receive,18841425565,1230297
18842656223,84,4,receive,18841425678,1230545
18842656578,164,2,receive,18841427217,1229361
18842657042,168,2,receive,18841427524,1229518
18842657407,172,1,receive,18841427625,1229782
18842657770,158,5,receive,18841428464,1229306
18842658126,132,2,receive,18841428579,1229547
18842658487,118,6,receive,18841429393,1229094
18842658843,150,3,receive,18841429975,1228868
18842708096,140,9,receive,18841430860,1277236
18842708511,140,10,receive,18841431015,1277496
18842709107,64,3,receive,18841431338,1277769
18842709556,28,5,receive,18841431670,1277886
18842710331,78,2,receive,18841433479,1276852
18842710852,186,1,receive,18841434160,1276692
18842711229,184,2,receive,18841434274,1276955
18842711600,106,2,receive,18841434815,1276785
18842711967,46,4,receive,18841435295,1276672
18842712340,6,6,receive,18841435479,1276861
18842712772,64,4,receive,18841435682,1277090
18842761032,30,2,receive,18841436304,1324728
18842761419,92,4,receive,18841436913,1324506
18842761835,132,3,receive,18841439057,1322778
18842762234,112,2,receive,18841439377,1322857
18842762606,60,2,receive,18841440018,1322588
18842762975,122,5,receive,18841440303,1322672
18842763340,110,2,receive,18841440292,1323048
18842763706,200,2,receive,18841440539,1323167
18842764160,102,4,receive,18841440645,1323515
18842764576,174,1,receive,18841441323,1323253
18842764963,22,1,receive,18841442093,1322870
18842765326,168,3,receive,18841442346,1322980
18842765688,76,9,receive,18841442614,1323074
18842766152,180,3,receive,18841442729,1323423
18842814818,154,5,receive,18841442939,1371879
18842815194,194,2,receive,18841443033,1372161
18842815587,14,2,receive,18841444078,1371509
18842815983,84,5,receive,18841444999,1370984
18842816355,140,11,receive,18841445235,1371120
18842816724,170,2,receive,18841445630,1371094
18842817245,70,5,receive,18841447520,1369725
18842817639,94,2,receive,18841448245,1369394
18842818124,138,3,receive,18841448355,1369769
18842818516,152,3,receive,18841448425,1370091
18842818881,158,6,receive,18841449746,1369135
18842819243,156,4,receive,18841449772,1369471
18842819606,42,4,receive,18841450340,1369266
18842820108,26,5,receive,18841451198,1368910
18842868141,16,3,receive,18841451391,1416750
18842868598,80,6,receive,18841452503,1416095
18842868984,66,4,receive,18841453576,1415408
18842869364,66,5,receive,18841453741,1415623
18842869810,24,2,receive,18841448067,1421743
18842870195,158,7,receive,18841453944,1416251
18842870566,88,2,receive,18841453971,1416595
18842870931,54,4,receive,18841454004,1416927
18842871297,104,2,receive,18841454291,1417006
18842871740,178,2,receive,18841454596,1417144
18842872123,48,3,receive,18841454817,1417306
18842872538,4,1,receive,18841455267,1417271
18842920845,162,2,receive,18841455911,1464934
18842921351,136,6,receive,18841456378,1464973
18842921742,132,4,receive,18841458545,1463197
18842922122,116,1,receive,18841458675,1463447
18842922500,80,7,receive,18841458793,1463707
18842922902,38,4,receive,18841459804,1463098
18842923410,114,3,receive,18841460010,1463400
18842923839,80,8,receive,18841460010,1463829
18842924240,30,3,receive,18841460014,1464226
18842924697,46,5,receive,18841460061,1464636
18842925072,124,2,receive,18841460306,1464766
18842925450,144,3,receive,18841460404,1465046
18842925878,86,9,receive,18841460496,1465382
18842973173,36,6,receive,18841460778,1512395
18842973638,36,7,receive,18841460926,1512712
18842974069,102,5,receive,18841460907,1513162
18842974508,34,6,receive,18841461034,1513474
18842974955,92,5,receive,18841461229,1513726
18842975376,76,10,receive,18841461908,1513468
18842975836,142,3,receive,18841462051,1513785
18842976294,40,5,receive,18841462518,1513776
18842976720,96,6,receive,18841462581,1514139
18842977224,146,3,receive,18841445866,1531358
18842977639,186,2,receive,18841464273,1513366
18842978050,56,5,receive,18841464548,1513502
18842978461,52,5,receive,18841465177,1513284
18843026863,142,4,receive,18841465292,1561571
18843027250,146,4,receive,18841465413,1561837
18843027623,70,6,receive,18841465807,1561816
18843028018,178,3,receive,18841500596,1527422
18843028473,26,7,receive,18841500840,1527633
18843028851,124,4,receive,18841500880,1527971
18843029224,140,13,receive,18841500933,1528291
18843029596,74,2,receive,18841471475,1558121
18843030008,96,8,receive,18841501222,1528786
18843030620,192,4,receive,18841466300,1564320
18843031146,178,4,receive,18841501778,1529368
18843031512,86,10,receive,18841501849,1529663
18843031899,138,4,receive,18841502033,1529866
18843079887,172,3,receive,18841502322,1577565
18843080301,158,8,receive,18841502289,1578012
18843080710,168,5,receive,18841502511,1578199
18843081104,134,5,receive,18841503120,1577984
18843081469,122,7,receive,18841504033,1577436
18843081832,70,7,receive,18841505238,1576594
18843082199,96,9,receive,18841505408,1576791
18843082620,128,2,receive,18841451092,1631528
18843083028,14,5,receive,18841506824,1576204
18843083392,80,9,receive,18841507479,1575913
18843083777,128,3,receive,18841508148,1575629
18843084134,28,8,receive,18841508538,1575596
18843084495,2,2,receive,18841478221,1606274
18843131879,64,6,receive,18841510539,1621340
18843132263,26,8,receive,18841511030,1621233
18843132628,154,7,receive,18841511583,1621045
18843133020,4,4,receive,18841511611,1621409
18843133424,118,9,receive,18841511777,1621647
18843133843,30,4,receive,18841512035,1621808
18843134283,94,4,receive,18841512680,1621603
18843134656,114,5,receive,18841512876,1621780
18843135059,46,6,receive,18841514651,1620408
18843135452,88,4,receive,18841514878,1620574
18843135827,124,5,receive,18841514983,1620844
18843136202,8,2,receive,18841515097,1621105
18843179373,8,3,receive,18841515283,1664090
18843179844,184,4,receive,18841515603,1664241
18843180251,114,6,receive,18841516092,1664159
18843180645,116,3,receive,18841508921,1671724
18843181063,128,4,receive,18841516592,1664471
18843181441,114,7,receive,18841517257,1664184
18843181893,122,8,receive,18841518240,1663653
18843182270,24,5,receive,18841518855,1663415
18843182646,140,14,receive,18841519145,1663501
18843183012,162,4,receive,18841520028,1662984
18843183377,86,11,receive,18841520079,1663298
18843183825,76,13,receive,18841520782,1663043
18843227137,64,7,receive,18841520789,1706348
18843227535,180,6,receive,18841521117,1706418
18843227945,48,8,receive,18841521129,1706816
18843228314,96,10,receive,18841521628,1706686
18843228888,174,3,receive,18841522068,1706820
18843229271,70,8,receive,18841522470,1706801
18843229779,136,8,receive,18841524167,1705612
18843230193,164,5,receive,18841524328,1705865
18843230777,42,6,receive,18841524508,1706269
18843231206,192,5,receive,18841524910,1706296
18843231664,156,6,receive,18841525765,1705899
18843274773,128,5,receive,18841526827,1747946
18843275164,178,5,receive,18841526988,1748176
18843275577,118,10,receive,18841528989,1746588
18843276759,84,7,receive,18841529671,1747088
18843277141,150,6,receive,18841531116,1746025
18843277498,40,8,receive,18841531365,1746133
18843277867,146,6,receive,18841531387,1746480
18843278424,38,8,receive,18841531695,1746729
18843278847,188,4,receive,18841531881,1746966
18843279255,42,7,receive,18841532761,1746494
18843327847,120,11,receive,18841533253,1794594
18843328256,188,5,receive,18841534140,1794116
18843328753,78,4,receive,18841535175,1793578
18843329180,114,8,receive,18841535472,1793708
18843329648,24,6,receive,18841536082,1793566
18843330026,76,14,receive,18841537023,1793003
18843330395,150,7,receive,18841537333,1793062
18843330757,148,1,receive,18841537877,1792880
18843331113,96,11,receive,18841537926,1793187
18843331563,168,6,receive,18841538653,1792910
18843331946,154,8,receive,18841538835,1793111
18843332334,134,6,receive,18841539377,1792957
18843375539,134,7,receive,18841539530,1836009
18843375935,34,8,receive,18841539584,1836351
18843376388,106,6,receive,18841537066,1839322
18843376769,192,6,receive,18841540292,1836477
18843377168,70,9,receive,18841540685,1836483
18843377553,128,6,receive,18841542078,1835475
18843377923,172,4,receive,18841542152,1835771
18843378285,46,7,receive,18841543130,1835155
18843378647,28,9,receive,18841543860,1834787
18843379007,34,9,receive,18841543855,1835152
18843379449,84,8,receive,18841544085,1835364
18843379825,118,11,receive,18841544269,1835556
18843428651,162,5,receive,18841544304,1884347
18843429097,30,5,receive,18841544287,1884810
18843429491,166,2,receive,18841389871,2039620
18843429874,158,9,receive,18841544666,1885208
18843430445,134,8,receive,18841544681,1885764
18843430867,54,6,receive,18841545284,1885583
18843431266,158,10,receive,18841545832,1885434
18843431639,164,6,receive,18841546640,1884999
18843432084,180,7,receive,18841547371,1884713
18843432475,108,1,receive,18841548209,1884266
18843432917,138,5,receive,18841549309,1883608
18843433298,14,6,receive,18841549873,1883425
18843433676,20,4,receive,18841411866,2021810
18843482031,64,8,receive,18841550149,1931882
18843482431,44,1,receive,18841550178,1932253
18843482809,120,12,receive,18841551474,1931335
18843483258,192,7,receive,18841551593,1931665
18843483625,70,10,receive,18841551916,1931709
18843483990,28,10,receive,18841552038,1931952
18843484356,122,9,receive,18841554838,1929518
18843484727,80,10,receive,18841555980,1928747
18843485144,116,4,receive,18841556215,1928929
18843485513,28,11,receive,18841556211,1929302
18843485886,84,9,receive,18841556371,1929515
18843486340,2,3,receive,18841557184,1929156
18843486719,82,1,receive,18841558026,1928693
18843534723,76,15,receive,18841558303,1976420
18843535137,26,9,receive,18841558407,1976730
18843535519,24,7,receive,18841559341,1976178
18843535912,46,8,receive,18841559425,1976487
18843536295,164,7,receive,18841559861,1976434
18843536724,8,4,receive,18841561406,1975318
18843537201,184,5,receive,18841562656,1974545
18843537620,132,6,receive,18841562754,1974866
18843538033,140,15,receive,18841563520,1974513
18843538457,42,8,receive,18841564149,1974308
18843538881,70,11,receive,18841565166,1973715
18843539276,146,7,receive,18841565743,1973533
18843587426,154,9,receive,18841566112,2021314
18843587824,4,5,receive,18841566381,2021443
18843588200,10,2,receive,18841418508,2169692
18843588567,150,8,receive,18841566586,2021981
18843588937,48,9,receive,18841566973,2021964
18843589395,174,4,receive,18841567347,2022048
18843589784,44,2,receive,18841568500,2021284
18843590446,128,7,receive,18841569375,2021071
18843590821,26,10,receive,18841569620,2021201
18843591317,38,9,receive,18841569937,2021380
18843591715,182,1,receive,18841570033,2021682
18843592106,106,7,receive,18841571337,2020769
18843640286,178,6,receive,18841571376,2068910
18843640692,136,9,receive,18841572649,2068043
18843641082,40,9,receive,18841572703,2068379
18843641481,56,7,receive,18841517272,2124209
18843641980,144,4,receive,18841520012,2121968
18843642375,118,12,receive,18841573531,2068844
18843642964,46,9,receive,18841573738,2069226
18843643364,158,11,receive,18841574102,2069262
18843644350,90,1,receive,18841574373,2069977
18843644810,4,6,receive,18841574591,2070219
18843645204,26,11,receive,18841574804,2070400
18843645616,78,5,receive,18841576557,2069059
18843695769,10,3,receive,18841576599,2119170
18843696182,30,6,receive,18841576676,2119506
18843696579,98,4,receive,18841456372,2240207
18843696965,98,5,receive,18841576897,2120068
18843697373,118,13,receive,18841577732,2119641
18843697769,48,10,receive,18841578237,2119532
18843698138,96,12,receive,18841578330,2119808
18843698527,2,4,receive,18841579521,2119006
18843698894,154,10,receive,18841580007,2118887
18843699409,140,8,receive,18841424670,2274739
18843700332,190,2,receive,18841510019,2190313
18843749108,174,5,receive,18841580547,2168561
18843749491,120,13,receive,18841580710,2168781
18843750032,42,9,receive,18841582362,2167670
18843750466,162,6,receive,18841584118,2166348
18843750911,154,11,receive,18841585203,2165708
18843751291,2,5,receive,18841585782,2165509
18843751663,46,10,receive,18841586072,2165591
18843752035,132,7,receive,18841586073,2165962
18843752468,80,11,receive,18841586319,2166149
18843752850,64,9,receive,18841587566,2165284
18843753231,94,5,receive,18841557061,2196170
18843753612,168,7,receive,18841588195,2165417
18843801429,34,10,receive,18841588292,2213137
18843801825,114,9,receive,18841577858,2223967
18843802221,82,2,receive,18841589429,2212792
18843802620,82,3,receive,18841589609,2213011
18843803048,112,4,receive,18841493445,2309603
18843803438,54,7,receive,18841590647,2212791
18843803815,150,9,receive,18841591095,2212720
18843804186,96,13,receive,18841591578,2212608
18843804592,82,4,receive,18841591844,2212748
18843804982,196,1,receive,18841591887,2213095
18843805437,162,7,receive,18841592278,2213159
18843805818,178,7,receive,18841592466,2213352
18843806217,162,8,receive,18841593439,2212778
18843806617,70,12,receive,18841595721,2210896
18843854021,174,7,receive,18841596903,2257118
18843854431,60,3,receive,18841488048,2366383
18843854830,130,2,receive,18841332370,2522460
18843855230,134,9,receive,18841598435,2256795
18843855602,116,5,receive,18841598645,2256957
18843856192,14,7,receive,18841599297,2256895
18843856639,28,12,receive,18841599498,2257141
18843857038,28,13,receive,18841599654,2257384
18843857520,138,6,receive,18841599874,2257646
18843857902,146,8,receive,18841599885,2258017
18843858276,146,9,receive,18841600075,2258201
18843858776,140,16,receive,18841600882,2257894
18843906174,122,10,receive,18841601136,2305038
18843906590,14,8,receive,18841601473,2305117
18843906964,76,16,receive,18841601874,2305090
18843907327,26,12,receive,18841601983,2305344
18843907697,192,8,receive,18841602249,2305448
18843908123,128,8,receive,18841602719,2305404
18843908491,96,14,receive,18841602857,2305634
18843908858,128,9,receive,18841602922,2305936
18843909228,150,10,receive,18841603277,2305951
18843909594,122,11,receive,18841603429,2306165
18843910037,116,6,receive,18841603814,2306223
18843910467,56,8,receive,18841604020,2306447
18843910832,140,17,receive,18841604135,2306697
18843959252,24,8,receive,18841605910,2353342
18843959655,122,12,receive,18841607661,2351994
18843960063,186,5,receive,18841524036,2436027
18843960449,184,6,receive,18841608202,2352247
18843960951,132,8,receive,18841608378,2352573
18843961378,36,9,receive,18841535781,2425597
18843961772,64,10,receive,18841609526,2352246
18843962158,112,6,receive,18841609804,2352354
18843962631,142,5,receive,18841499817,2462814
18843963050,44,3,receive,18841609890,2353160
18843963446,104,3,receive,18841509649,2453797
18843963821,8,5,receive,18841611055,2352766
18844012235,146,10,receive,18841611300,2400935
18844012662,8,6,receive,18841612305,2400357
18844013057,44,4,receive,18841613081,2399976
18844013551,120,14,receive,18841613134,2400417
18844014052,6,7,receive,18841467879,2546173
18844014434,78,6,receive,18841613968,2400466
18844014865,68,1,receive,18841614228,2400637
18844015235,146,11,receive,18841615470,2399765
18844015639,24,9,receive,18841616099,2399540
18844016038,140,18,receive,18841616320,2399718
18844016411,134,10,receive,18841616670,2399741
18844016780,54,8,receive,18841616954,2399826
18844017151,194,3,receive,18841492562,2524589
18844065602,136,10,receive,18841619025,2446577
18844066003,46,11,receive,18841619468,2446535
18844066389,126,5,receive,18841433446,2632943
18844066772,158,12,receive,18841621580,2445192
18844067246,78,7,receive,18841622119,2445127
18844067645,166,4,receive,18841622271,2445374
18844068113,130,3,receive,18841622963,2445150
18844068504,98,6,receive,18841623227,2445277
18844068926,30,7,receive,18841624208,2444718
18844069316,132,9,receive,18841624692,2444624
18844069788,190,3,receive,18841625080,2444708
18844125224,96,15,receive,18841625129,2500095
18844125646,118,14,receive,18841625155,2500491
18844126021,124,6,receive,18841544081,2581940
18844126397,168,8,receive,18841625747,2500650
18844126798,106,8,receive,18841626172,2500626
18844127183,104,4,receive,18841626236,2500947
18844127555,184,7,receive,18841626464,2501091
18844127996,14,9,receive,18841626725,2501271
18844128364,38,11,receive,18841627627,2500737
18844128773,178,8,receive,18841627759,2501014
18844129472,42,10,receive,18841629756,2499716
18844129865,10,4,receive,18841630008,2499857
18844130270,162,9,receive,18841630808,2499462
18844177738,14,10,receive,18841630907,2546831
18844178121,138,7,receive,18841631178,2546943
18844178523,44,5,receive,18841631384,2547139
18844178953,154,12,receive,18841631539,2547414
18844179829,192,9,receive,18841633530,2546299
18844180228,34,11,receive,18841633706,2546522
18844180597,38,12,receive,18841635776,2544821
18844180964,80,12,receive,18841635817,2545147
18844181340,132,10,receive,18841635962,2545378
18844181756,14,11,receive,18841636058,2545698
18844182136,158,13,receive,18841636768,2545368
18844225954,26,13,receive,18841637182,2588772
18844226374,114,10,receive,18841637372,2589002
18844226760,102,7,receive,18841537843,2688917
18844227133,96,16,receive,18841638378,2588755
18844227559,96,17,receive,18841638584,2588975
18844227934,36,10,receive,18841638591,2589343
18844228287,60,4,receive,18841638825,2589462
18844228640,64,11,receive,18841638839,2589801
18844229022,48,11,receive,18841639009,2590013
18844229430,36,16,receive,18841721332,2508098
18844229820,172,5,receive,18841569369,2660451
18844230781,86,14,receive,18841722727,2508054
18844278512,152,5,receive,18841722927,2555585
18844279070,142,10,receive,18841723022,2556048
18844279462,54,11,receive,18841723017,2556445
18844279870,64,13,receive,18841723318,2556552
18844280269,160,2,receive,18841678903,2601366
18844280656,184,11,receive,18841723641,2557015
18844281097,170,5,receive,18841723934,2557163
18844281470,88,5,receive,18841544227,2737243
18844281843,114,15,receive,18841725565,2556278
18844282223,158,18,receive,18841725698,2556525
18844282597,106,13,receive,18841726329,2556268
18844283045,130,6,receive,18841726878,2556167
18844283486,100,6,receive,18841727108,2556378
18844283890,46,14,receive,18841727030,2556860
18844284269,38,14,receive,18841727476,2556793
18844331950,136,13,receive,18841727885,2604065
18844332328,130,7,receive,18841728050,2604278
18844332696,128,12,receive,18841728580,2604116
18844333061,154,16,receive,18841728638,2604423
18844333458,120,18,receive,18841729573,2603885
18844333828,182,2,receive,18841597197,2736631
18844334254,72,1,receive,18841730066,2604188
18844334644,66,8,receive,18841730855,2603789
18844335528,8,10,receive,18841730015,2605513
18844335912,60,7,receive,18841732018,2603894
18844336298,70,13,receive,18841613963,2722335
18844336672,28,19,receive,18841733323,2603349
18844384873,94,6,receive,18841636130,2748743
18844385272,22,5,receive,18841733772,2651500
18844385700,184,12,receive,18841733892,2651808
18844386076,84,10,receive,18841601736,2784340
18844386449,118,21,receive,18841734778,2651671
18844386858,34,15,receive,18841734828,2652030
18844387244,152,6,receive,18841735194,2652050
18844387670,134,14,receive,18841735797,2651873
18844388057,60,8,receive,18841736232,2651825
18844388439,68,5,receive,18841736824,2651615
18844388807,110,3,receive,18841486367,2902440
18844389178,74,5,receive,18841737428,2651750
18844389595,102,11,receive,18841737553,2652042
18844443005,52,9,receive,18841737705,2705300
18844443402,84,11,receive,18841738132,2705270
18844443789,134,15,receive,18841738972,2704817
18844444152,92,8,receive,18841535245,2908907
18844444533,74,6,receive,18841740622,2703911
18844444890,74,7,receive,18841740775,2704115
18844445251,38,15,receive,18841741098,2704153
18844445706,50,2,receive,18841428319,3017387
18844446081,96,23,receive,18841741323,2704758
18844446460,194,6,receive,18841741433,2705027
18844446935,98,11,receive,18841741440,2705495
18844447387,198,3,receive,18841741593,2705794
18844490216,120,19,receive,18841741782,2748434
18844490614,122,16,receive,18841742237,2748377
18844491009,80,18,receive,18841742320,2748689
18844491378,184,13,receive,18841743119,2748259
18844491762,56,9,receive,18841646408,2845354
18844492123,26,16,receive,18841744425,2747698
18844492490,128,13,receive,18841744784,2747706
18844492940,142,11,receive,18841746438,2746502
18844493366,170,6,receive,18841747203,2746163
18844493748,182,3,receive,18841747346,2746402
18844494136,42,15,receive,18841747358,2746778
18844494603,140,24,receive,18841747667,2746936
18844538035,22,6,receive,18841747969,2790066
18844538436,116,10,receive,18841748621,2789815
18844538816,120,20,receive,18841749952,2788864
18844539188,178,9,receive,18841674209,2864979
18844539634,144,5,receive,18841578180,2961454
18844540035,156,7,receive,18841563112,2976923
18844540398,144,6,receive,18841750197,2790201
18844540756,80,19,receive,18841751534,2789222
18844541150,54,12,receive,18841753341,2787809
18844541703,144,7,receive,18841753414,2788289
18844542192,56,10,receive,18841753733,2788459
18844542599,76,21,receive,18841754251,2788348
18844590120,72,2,receive,18841754525,2835595
18844590602,88,6,receive,18841725339,2865263
18844590982,100,7,receive,18841755410,2835572
18844591353,90,2,receive,18841588707,3002646
18844592343,36,17,receive,18841755746,2836597
18844592754,22,7,receive,18841756122,2836632
18844593142,66,9,receive,18841756187,2836955
18844593810,144,8,receive,18841756638,2837172
18844594422,142,12,receive,18841756681,2837741
18844594808,170,7,receive,18841757388,2837420
18844595190,134,16,receive,18841758188,2837002
18844644283,186,6,receive,18841635373,3008910
18844644664,192,10,receive,18841684669,2959995
18844645095,114,16,receive,18841758855,2886240
18844645485,118,22,receive,18841759044,2886441
18844645852,130,8,receive,18841759316,2886536
18844646218,118,23,receive,18841760230,2885988
18844646675,174,8,receive,18841650794,2995881
18844647698,22,8,receive,18841761292,2886406
18844648171,54,13,receive,18841765061,2883110
18844648590,34,16,receive,18841765135,2883455
18844648990,170,8,receive,18841765568,2883422
18844696750,10,10,receive,18841765594,2931156
18844697143,60,9,receive,18841765772,2931371
18844697978,16,5,receive,18841548173,3149805
18844698573,120,21,receive,18841766172,2932401
18844699298,110,4,receive,18841766644,2932654
18844699787,110,5,receive,18841766802,2932985
18844700395,34,17,receive,18841767301,2933094
18844701238,168,9,receive,18841633887,3067351
18844749344,140,25,receive,18841767836,2981508
18844749738,42,16,receive,18841768576,2981162
18844750119,16,6,receive,18841769344,2980775
18844750483,66,10,receive,18841769483,2981000
18844750841,190,9,receive,18841770238,2980603
18844751308,86,15,receive,18841772101,2979207
18844751680,28,20,receive,18841771263,2980417
18844752092,110,6,receive,18841772976,2979116
18844752473,8,11,receive,18841773292,2979181
18844752852,122,17,receive,18841774795,2978057
18844753279,80,20,receive,18841774838,2978441
18844753676,56,11,receive,18841775020,2978656
18844754069,118,24,receive,18841775424,2978645
18844754454,198,4,receive,18841775833,2978621
18844802389,140,26,receive,18841776021,3026368
18844802817,158,19,receive,18841776064,3026753
18844803238,186,7,receive,18841776432,3026806
18844803616,46,15,receive,18841776504,3027112
18844804189,136,14,receive,18841777287,3026902
18844806145,96,24,receive,18841777676,3028469
18844806617,102,12,receive,18841779002,3027615
18844807070,152,7,receive,18841779502,3027568
18844807459,30,11,receive,18841708602,3098857
18844807840,52,10,receive,18841781709,3026131
18844856492,68,6,receive,18841781988,3074504
18844856919,186,8,receive,18841782606,3074313
18844857318,182,4,receive,18841782657,3074661
18844857999,186,9,receive,18841783766,3074233
18844858381,186,10,receive,18841783886,3074495
18844859162,8,12,receive,18841785508,3073654
18844860096,156,8,receive,18841785524,3074572
18844860549,82,7,receive,18841711636,3148913
18844860994,148,2,receive,18841574296,3286698
18844910373,74,8,receive,18841788111,3122262
18844910753,120,22,receive,18841788415,3122338
18844911759,76,22,receive,18841788601,3123158
18844913107,46,16,receive,18841788733,3124374
18844913631,180,8,receive,18841572803,3340828
18844914144,186,11,receive,18841789019,3125125
18844914543,110,7,receive,18841789210,3125333
18844914934,120,23,receive,18841790597,3124337
18844963857,80,21,receive,18841781050,3182807
18844964264,4,7,receive,18841603874,3360390
18844964657,90,3,receive,18841792901,3171756
18844965169,116,11,receive,18841793037,3172132
18844965985,36,18,receive,18841793156,3172829
18844966416,48,15,receive,18841720731,3245685
18844966888,190,10,receive,18841794878,3172010
18844967288,52,11,receive,18841797002,3170286
18844967741,136,15,receive,18841797441,3170300
18844968122,88,7,receive,18841797956,3170166
18844968545,68,7,receive,18841798193,3170352
18844968934,34,18,receive,18841798535,3170399
18845022895,42,17,receive,18841798872,3224023
18845023298,100,8,receive,18841799816,3223482
18845023728,170,9,receive,18841799852,3223876
18845024113,196,2,receive,18841600169,3423944
18845024540,78,8,receive,18841636304,3388236
18845025027,96,25,receive,18841800192,3224835
18845025479,68,8,receive,18841800365,3225114
18845025866,166,7,receive,18841676492,3349374
18845026309,66,11,receive,18841800892,3225417
18845026741,108,3,receive,18841727853,3298888
18845027175,182,5,receive,18841802918,3224257
18845027634,180,9,receive,18841804194,3223440
18845076124,168,10,receive,18841805096,3271028
18845076541,144,9,receive,18841805106,3271435
18845076907,116,12,receive,18841805200,3271707
18845077277,144,10,receive,18841805309,3271968
18845077673,136,16,receive,18841805682,3271991
18845078080,42,18,receive,18841806058,3272022
18845078447,86,16,receive,18841807179,3271268
18845078823,114,17,receive,18841807187,3271636
18845079201,22,9,receive,18841807576,3271625
18845079575,42,19,receive,18841809249,3270326
18845080140,130,9,receive,18841809656,3270484
18845080527,122,18,receive,18841811199,3269328
18845080910,186,12,receive,18841811246,3269664
18845130184,100,9,receive,18841811997,3318187
18845130583,118,25,receive,18841812705,3317878
18845131009,116,13,receive,18841813388,3317621
18845131393,56,12,receive,18841813357,3318036
18845131771,96,26,receive,18841813572,3318199
18845132143,152,8,receive,18841813765,3318378
18845132514,170,10,receive,18841814060,3318454
18845132911,34,19,receive,18841814778,3318133
18845133301,198,5,receive,18841815174,3318127
18845133694,162,13,receive,18841727344,3406350
18845134179,74,9,receive,18841815425,3318754
18845134623,140,27,receive,18841815698,3318925
18845135052,56,13,receive,18841816624,3318428
18845135478,90,4,receive,18841817159,3318319
18845135851,140,28,receive,18841817899,3317952
18845187040,8,13,receive,18841818877,3368163
18845187420,126,9,receive,18841739219,3448201
18845187819,140,29,receive,18841820599,3367220
18845188215,158,20,receive,18841822474,3365741
18845188597,28,21,receive,18841822963,3365634
18845189028,78,9,receive,18841824553,3364475
18845189411,104,7,receive,18841699199,3490212
18845189784,104,8,receive,18841825131,3364653
18845190209,68,9,receive,18841825431,3364778
18845190618,118,26,receive,18841825919,3364699
18845191006,24,10,receive,18841641426,3549580
18845191729,110,8,receive,18841826548,3365181
18845249116,20,5,receive,18841591400,3657716
18845249531,34,20,receive,18841828009,3421522
18845249909,126,10,receive,18841828263,3421646
18845250346,180,10,receive,18841828478,3421868
18845250801,116,14,receive,18841828612,3422189
18845251299,4,8,receive,18841829214,3422085
18845251748,58,3,receive,18841742824,3508924
18845252204,68,10,receive,18841829569,3422635
18845252618,150,14,receive,18841717712,3534906
18845253014,100,10,receive,18841831174,3421840
18845253434,86,17,receive,18841831453,3421981
18845300036,96,27,receive,18841831797,3468239
18845300521,22,10,receive,18841832777,3467744
18845300914,78,10,receive,18841832985,3467929
18845301299,8,14,receive,18841833097,3468202
18845301683,182,6,receive,18841833287,3468396
18845302069,186,13,receive,18841833436,3468633
18845302545,22,11,receive,18841834911,3467634
18845302925,120,24,receive,18841835026,3467899
18845303307,136,17,receive,18841835073,3468234
18845303712,16,7,receive,18841797629,3506083
18845304219,36,19,receive,18841835547,3468672
18845304650,36,20,receive,18841836746,3467904
18845305241,76,23,receive,18841837003,3468238
18845361927,22,12,receive,18841837036,3524891
18845362408,162,14,receive,18841838645,3523763
18845363128,130,10,receive,18841839909,3523219
18845363640,200,5,receive,18841716123,3647517
18845364033,24,11,receive,18841841688,3522345
18845364420,96,28,receive,18841842009,3522411
18845364794,136,18,receive,18841842201,3522593
18845365185,88,8,receive,18841842303,3522882
18845365635,80,22,receive,18841842369,3523266
18845366069,132,14,receive,18841742394,3623675
18845366458,110,9,receive,18841843747,3522711
18845416064,78,11,receive,18841845258,3570806
18845416451,42,20,receive,18841846483,3569968
18845416913,24,12,receive,18841846908,3570005
18845417306,52,12,receive,18841847466,3569840
18845417724,106,14,receive,18841775725,3641999
18845418148,16,8,receive,18841848527,3569621
18845418537,12,6,receive,18841758587,3659950
18845418929,56,14,receive,18841851139,3567790
18845419316,168,11,receive,18841851474,3567842
18845419822,150,15,receive,18841852376,3567446
18845420227,18,2,receive,18841716566,3703661
18845420597,76,24,receive,18841853240,3567357
18845477518,112,13,receive,18841741906,3735612
18845478105,58,4,receive,18841853767,3624338
18845478523,56,15,receive,18841854322,3624201
18845478936,114,18,receive,18841854476,3624460
18845479340,92,9,receive,18841790465,3688875
18845479765,104,9,receive,18841826314,3653451
18845480173,104,10,receive,18841855826,3624347
18845480583,34,21,receive,18841856310,3624273
18845480977,100,11,receive,18841856360,3624617
18845481358,22,13,receive,18841857182,3624176
18845481733,2,7,receive,18841734112,3747621
18845482492,164,9,receive,18841770008,3712484
18845529972,106,15,receive,18841857940,3672032
18845530379,18,3,receive,18841858967,3671412
18845530752,170,11,receive,18841859452,3671300
18845531169,52,13,receive,18841859733,3671436
18845531574,140,30,receive,18841859882,3671692
18845531954,124,7,receive,18841638543,3893411
18845532326,28,22,receive,18841860356,3671970
18845532693,76,25,receive,18841861458,3671235
18845533062,44,7,receive,18841664818,3868244
18845533430,180,11,receive,18841861815,3671615
18845533869,22,14,receive,18841862321,3671548
18845534239,90,5,receive,18841862532,3671707
18845534604,114,19,receive,18841862664,3671940
18845587830,162,15,receive,18841862907,3724923
18845588276,70,14,receive,18841741386,3846890
18845589051,56,16,receive,18841864536,3724515
18845589737,140,31,receive,18841866056,3723681
18845590150,186,14,receive,18841866754,3723396
18845590542,98,12,receive,18841757659,3832883
18845590936,52,14,receive,18841866993,3723943
18845591359,130,11,receive,18841867196,3724163
18845591730,186,15,receive,18841867934,3723796
18845592095,176,4,receive,18841726486,3865609
18845592457,182,7,receive,18841868675,3723782
18845592814,126,11,receive,18841869873,3722941
18845593205,194,7,receive,18841779767,3813438
18845646539,14,12,receive,18841677104,3969435
18845646934,4,9,receive,18841870013,3776921
18845647326,36,21,receive,18841870187,3777139
18845647727,118,27,receive,18841870297,3777430
18845648119,68,11,receive,18841870850,3777269
18845648549,92,10,receive,18841871691,3776858
18845648942,178,10,receive,18841769258,3879684
18845649326,104,11,receive,18841873111,3776215
18845649702,162,16,receive,18841873247,3776455
18845650098,120,25,receive,18841873381,3776717
18845650536,64,14,receive,18841737585,3912951
18845650928,104,12,receive,18841876316,3774612
18845703562,100,12,receive,18841876909,3826653
18845703965,116,15,receive,18841878871,3825094
18845704354,56,17,receive,18841879822,3824532
18845704772,132,15,receive,18841880793,3823979
18845705171,114,20,receive,18841880878,3824293
18845705620,176,5,receive,18841882205,3823415
18845706012,64,15,receive,18841741873,3964139
18845706402,182,8,receive,18841883918,3822484
18845706930,6,10,receive,18841730601,3976329
18845707342,148,3,receive,18841813422,3893920
18845707841,34,22,receive,18841885618,3822223
18845773884,54,14,receive,18841801463,3972421
18845774299,126,12,receive,18841886251,3888048
18845774731,36,22,receive,18841886464,3888267
18845775121,6,11,receive,18841885753,3889368
18845775486,100,13,receive,18841888136,3887350
18845775852,148,4,receive,18841888404,3887448
18845776217,88,9,receive,18841889644,3886573
18845776609,52,15,receive,18841890310,3886299
18845776998,96,29,receive,18841890307,3886691
18845777368,68,12,receive,18841892079,3885289
18845777736,100,14,receive,18841892273,3885463
18845778154,62,2,receive,18841595400,4182754
18845778558,78,12,receive,18841892579,3885979
18845834755,114,21,receive,18841893077,3941678
18845835145,90,6,receive,18841893144,3942001
18845835524,52,16,receive,18841893528,3941996
18845835965,100,15,receive,18841894435,3941530
18845836351,42,21,receive,18841895933,3940418
18845836724,32,3,receive,18841744069,4092655
18845837095,170,12,receive,18841896667,3940428
18845837464,168,12,receive,18841896843,3940621
18845838011,172,6,receive,18841763313,4074698
18845838449,150,16,receive,18841898735,3939714
18845838834,138,10,receive,18841743273,4095561
18845839210,16,9,receive,18841898916,3940294
18845839587,180,12,receive,18841899050,3940537
18845882451,192,11,receive,18841761948,4120503
18845883042,12,7,receive,18841900457,3982585
18845883422,164,10,receive,18841900596,3982826
18845883816,58,5,receive,18841902202,3981614
18845884187,164,11,receive,18841902772,3981415
18845884548,132,16,receive,18841904107,3980441
18845885057,130,12,receive,18841904524,3980533
18845885438,162,17,receive,18841905507,3979931
18845885814,22,15,receive,18841905643,3980171
18845886184,162,18,receive,18841906681,3979503
18845886551,100,16,receive,18841907616,3978935
18845886993,2,8,receive,18841907671,3979322
18845945313,144,11,receive,18841810524,4134789
18845945818,178,11,receive,18841881295,4064523
18845946205,4,10,receive,18841909463,4036742
18845946588,158,21,receive,18841866882,4079706
18845947007,28,23,receive,18841910751,4036256
18845947413,174,9,receive,18841789335,4158078
18845947783,172,7,receive,18841912888,4034895
18845948156,196,3,receive,18841826348,4121808
18845948529,186,16,receive,18841914304,4034225
18845948971,62,3,receive,18841914678,4034293
18845949356,62,4,receive,18841914806,4034550
18845949729,138,11,receive,18841915164,4034565
18845950112,52,17,receive,18841915836,4034276
18845950475,68,13,receive,18841916290,4034185
18846004562,140,32,receive,18841916447,4088115
18846004953,2,9,receive,18841916839,4088114
18846005435,34,23,receive,18841910912,4094523
18846005814,8,15,receive,18841881443,4124371
18846006191,12,8,receive,18841917746,4088445
18846006587,82,8,receive,18841804222,4202365
18846007001,146,13,receive,18841690013,4316988
18846007375,184,14,receive,18841759384,4247991
18846007744,186,17,receive,18841920480,4087264
18846008111,104,13,receive,18841921651,4086460
18846008472,88,10,receive,18841921925,4086547
18846008860,154,17,receive,18841779115,4229745
18846009308,22,16,receive,18841923861,4085447
18846063494,28,24,receive,18841924003,4139491
18846063880,164,12,receive,18841924079,4139801
18846064271,170,13,receive,18841925074,4139197
18846064667,28,25,receive,18841925189,4139478
18846065048,66,12,receive,18841805163,4259885
18846065419,38,16,receive,18841767319,4298100
18846065790,48,16,receive,18841839857,4225933
18846066164,68,14,receive,18841928502,4137662
18846066653,6,12,receive,18841928914,4137739
18846067162,62,5,receive,18841928968,4138194
18846067611,134,17,receive,18841806614,4260997
18846116821,90,7,receive,18841929458,4187363
18846117337,112,14,receive,18841894212,4223125
18846117793,126,13,receive,18841932687,4185106
18846118164,78,13,receive,18841932952,4185212
18846118640,38,17,receive,18841933099,4185541
18846119010,130,13,receive,18841933824,4185186
18846119373,22,17,receive,18841934048,4185325
18846119815,140,33,receive,18841934679,4185136
18846120264,100,17,receive,18841934846,4185418
18846120637,142,13,receive,18841802956,4317681
18846121040,150,17,receive,18841935325,4185715
18846121407,28,26,receive,18841935378,4186029
18846122140,180,13,receive,18841935399,4186741
18846188397,100,18,receive,18841937017,4251380
18846189075,42,22,receive,18841937219,4251856
18846189462,148,5,receive,18841938793,4250669
18846189878,12,9,receive,18841939167,4250711
18846190266,22,18,receive,18841939231,4251035
18846190685,112,15,receive,18841934229,4256456
18846191058,146,14,receive,18841939530,4251528
18846191429,190,11,receive,18841819219,4372210
18846247608,44,8,receive,18841889027,4358581
18846248072,52,18,receive,18841942063,4306009
18846248562,76,26,receive,18841887689,4360873
18846248971,38,18,receive,18841943352,4305619
18846249378,186,18,receive,18841943761,4305617
18846250027,140,34,receive,18841943857,4306170
18846250415,162,19,receive,18841944112,4306303
18846250819,6,13,receive,18841944127,4306692
18846251206,30,12,receive,18841821043,4430163
18846251579,50,3,receive,18841784636,4466943
18846251949,188,8,receive,18841757738,4494211
18846252354,72,3,receive,18841785908,4466446
18846311457,6,14,receive,18841946277,4365180
18846311874,16,10,receive,18841947390,4364484
18846312246,128,14,receive,18841786169,4526077
18846312686,188,9,receive,18841947552,4365134
18846314457,26,17,receive,18841773744,4540713
18846314828,116,16,receive,18841904096,4410732
18846315192,172,8,receive,18841948306,4366886
18846315561,70,15,receive,18841883243,4432318
18846315953,98,13,receive,18841917288,4398665
18846316339,88,11,receive,18841950132,4366207
18846363613,52,19,receive,18841951238,4412375
18846364004,4,11,receive,18841951826,4412178
18846364400,60,10,receive,18841806130,4558270
18846364761,130,14,receive,18841953077,4411684
18846365569,132,17,receive,18841954537,4411032
18846365978,62,6,receive,18841956192,4409786
18846366644,60,11,receive,18841956270,4410374
18846367054,172,9,receive,18841957488,4409566
18846367426,196,4,receive,18841957891,4409535
18846367834,14,13,receive,18841883395,4484439
18846416952,174,10,receive,18841958425,4458527
18846417331,16,11,receive,18841958671,4458660
18846417721,186,19,receive,18841957004,4460717
18846418085,146,15,receive,18841959733,4458352
18846418530,104,14,receive,18841959906,4458624
18846418913,198,6,receive,18841848604,4570309
18846419331,124,8,receive,18841907816,4511515
18846419705,130,15,receive,18841962226,4457479
18846420172,24,13,receive,18841874235,4545937
18846420561,138,12,receive,18841962676,4457885
18846420924,170,14,receive,18841963328,4457596
18846421284,112,16,receive,18841963720,4457564
18846421645,48,17,receive,18841964016,4457629
18846422011,68,15,receive,18841949742,4472269
18846464756,164,13,receive,18841965431,4499325
18846465138,64,16,receive,18841887714,4577424
18846465504,172,10,receive,18841967672,4497832
18846465866,52,20,receive,18841968422,4497444
18846466295,40,11,receive,18841737806,4728489
18846466664,52,21,receive,18841969590,4497074
18846467029,152,9,receive,18841862166,4604863
18846467394,4,12,receive,18841970998,4496396
18846467778,88,12,receive,18841972420,4495358
18846468197,126,14,receive,18841973129,4495068
18846468569,174,11,receive,18841973682,4494887
18846468932,28,27,receive,18841973737,4495195
18846469294,64,17,receive,18841969402,4499892
18846469790,174,12,receive,18841973807,4495983
18846470442,16,12,receive,18841973907,4496535
18846516190,40,12,receive,18841971741,4544449
18846516870,180,14,receive,18841975754,4541116
18846517261,176,6,receive,18841923452,4593809
18846517633,186,20,receive,18841975955,4541678
18846518067,152,10,receive,18841976026,4542041
18846518456,136,19,receive,18841976058,4542398
18846518871,22,19,receive,18841976516,4542355
18846519273,24,14,receive,18841976500,4542773
18846519648,78,14,receive,18841977426,4542222
18846520051,86,18,receive,18841861644,4658407
18846520432,10,11,receive,18841798950,4721482
18846558472,128,15,receive,18841963775,4594697
18846558935,126,15,receive,18841979385,4579550
18846559323,90,8,receive,18841979739,4579584
18846559731,156,9,receive,18841813878,4745853
18846560125,108,4,receive,18841823105,4737020
18846560488,68,16,receive,18841980359,4580129
18846560850,12,10,receive,18841980627,4580223
18846561211,44,9,receive,18841980989,4580222
18846561578,148,6,receive,18841981399,4580179
18846562080,114,22,receive,18841917464,4644616
18846562494,46,17,receive,18841832161,4730333
18846562858,190,12,receive,18841982763,4580095
18846605968,94,7,receive,18841774087,4831881
18846609202,106,16,receive,18841894231,4714971
18846609964,188,10,receive,18841984118,4625846
18846610348,36,23,receive,18841913838,4696510
18846610844,190,13,receive,18841985915,4624929
18846611363,48,18,receive,18841986280,4625083
18846671546,6,15,receive,18841986517,4685029
18846671921,90,9,receive,18841986924,4684997
18846672287,138,13,receive,18841986964,4685323
18846672648,132,18,receive,18841987019,4685629
18846673036,100,19,receive,18841987357,4685679
18846673407,50,4,receive,18841987374,4686033
18846673822,42,23,receive,18841987589,4686233
18846674185,146,16,receive,18841987946,4686239
18846674540,94,8,receive,18841987959,4686581
18846674980,120,26,receive,18841903620,4771360
18846732675,4,13,receive,18841989223,4743452
18846733049,134,18,receive,18841944476,4788573
18846733407,54,15,receive,18841917542,4815865
18846733763,150,18,receive,18841976805,4756958
18846734149,140,35,receive,18841991214,4742935
18846734524,160,3,receive,18841743791,4990733
18846734886,84,12,receive,18841759423,4975463
18846735246,84,13,receive,18841992797,4742449
18846735603,162,20,receive,18841985481,4750122
18846736011,186,21,receive,18841993217,4742794
18846736458,140,36,receive,18841993442,4743016
18846736818,80,23,receive,18841878655,4858163
18846737397,108,5,receive,18841995215,4742182
18846737829,24,15,receive,18841995226,4742603
18846738256,152,11,receive,18841995355,4742901
18846779917,124,9,receive,18841995498,4784419
18846780323,90,10,receive,18841996109,4784214
18846780749,198,7,receive,18841973122,4807627
18846781121,100,20,receive,18841996537,4784584
18846781544,172,11,receive,18841996887,4784657
18846781912,94,9,receive,18841997204,4784708
18846782275,102,13,receive,18841828324,4953951
18846782704,60,12,receive,18841998629,4784075
18846783077,50,5,receive,18841999588,4783489
18846783525,68,17,receive,18842001610,4781915
18846783892,162,21,receive,18842002017,4781875
18846784256,174,13,receive,18842002047,4782209
18846817761,160,4,receive,18842002156,4815605
18846818141,196,5,receive,18842003331,4814810
18846818533,94,10,receive,18842003381,4815152
18846818910,104,15,receive,18842005314,4813596
18846819277,62,7,receive,18842005510,4813767
18846819641,38,19,receive,18841962549,4857092
18846820031,186,22,receive,18842006460,4813571
18846820401,20,6,receive,18841876902,4943499
18846820838,94,11,receive,18842009612,4811226
18846821220,50,6,receive,18842009819,4811401
18846821586,4,14,receive,18842010095,4811491
18846869199,40,13,receive,18841990873,4878326
18846869633,132,19,receive,18842011272,4858361
18846870052,4,15,receive,18842011345,4858707
18846870435,84,14,receive,18842011960,4858475
18846870882,2,10,receive,18841963236,4907646
18846871264,78,15,receive,18842012766,4858498
18846871644,72,4,receive,18841959900,4911744
18846872016,112,17,receive,18842013105,4858911
18846872392,146,17,receive,18842013241,4859151
18846872839,122,19,receive,18841857583,5015256
18846873217,62,8,receive,18842014702,4858515
18846916218,172,12,receive,18842017098,4899120
18846916604,44,10,receive,18842017745,4898859
18846917036,72,5,receive,18842018272,4898764
18846917400,188,11,receive,18842018314,4899086
18846917761,16,13,receive,18842019359,4898402
18846918129,72,6,receive,18842019470,4898659
18846918500,52,22,receive,18842019979,4898521
18846918949,110,10,receive,18841882018,5036931
18846919402,26,18,receive,18841981500,4937902
18846919815,60,13,receive,18842020905,4898910
18846920215,112,18,receive,18842021300,4898915
18846920609,124,10,receive,18842021845,4898764
18846959217,176,7,receive,18842023241,4935976
18846959665,180,15,receive,18841992620,4967045
18846960068,184,15,receive,18841949221,5010847
18846960445,148,7,receive,18842026790,4933655
18846960818,146,18,receive,18842027440,4933378
18846961196,30,13,receive,18841978635,4982561
18846961623,34,24,receive,18841948481,5013142
18846962021,44,11,receive,18842028953,4933068
18846962422,40,14,receive,18842029305,4933117
18846963082,188,12,receive,18842029520,4933562
18847002983,152,12,receive,18842029700,4973283
18847003387,12,11,receive,18842030011,4973376
18847004190,100,21,receive,18842030833,4973357
18847004645,140,37,receive,18842030863,4973782
18847005039,48,19,receive,18842014582,4990457
18847005427,192,12,receive,18841919388,5086039
18847005821,148,8,receive,18842034028,4971793
18847006209,176,8,receive,18842034494,4971715
18847006709,110,11,receive,18842035224,4971485
18847007208,94,12,receive,18842035968,4971240
18847057953,90,11,receive,18842036368,5021585
18847058444,172,13,receive,18842037236,5021208
18847058829,82,9,receive,18841955472,5103357
18847059244,92,11,receive,18841886940,5172304
18847059634,50,7,receive,18842039188,5020446
18847060030,40,15,receive,18842039545,5020485
18847060597,4,16,receive,18842039619,5020978
18847061180,64,18,receive,18842023171,5038009
18847061637,152,13,receive,18842039860,5021777
18847062019,78,16,receive,18842040012,5022007
18847062394,178,12,receive,18841959571,5102823
18847062763,74,10,receive,18841831719,5231044
18847063137,62,9,receive,18842040972,5022165
18847063502,46,18,receive,18842022205,5041297
18847108070,146,19,receive,18842041619,5066451
18847108458,20,7,receive,18842043029,5065429
18847108814,124,11,receive,18842043101,5065713
18847109286,102,14,receive,18842045763,5063523
18847109714,178,13,receive,18842046481,5063233
18847110115,10,12,receive,18842012552,5097563
18847110541,196,6,receive,18842046828,5063713
18847111254,172,14,receive,18842047380,5063874
18847111641,90,12,receive,18842047580,5064061
18847112003,86,19,receive,18842016336,5095667
18847112678,192,13,receive,18842048999,5063679
18847113287,44,12,receive,18842049152,5064135
18847114094,194,8,receive,18841905352,5208742
18847114596,78,17,receive,18842050009,5064587
18847115018,60,14,receive,18842050166,5064852
18847157526,86,20,receive,18842049936,5107590
18847157983,38,20,receive,18842048090,5109893
18847158468,176,9,receive,18842051692,5106776
18847158849,112,19,receive,18842052603,5106246
18847159282,58,6,receive,18841949451,5209831
18847159663,36,24,receive,18842020824,5138839
18847160048,128,16,receive,18841987381,5172667
18847209456,136,20,receive,18842020449,5189007
18847213813,90,13,receive,18842056761,5157052
18847214257,90,14,receive,18842056886,5157371
18847214758,108,6,receive,18842025514,5189244
18847215186,180,16,receive,18842036008,5179178
18847215769,116,17,receive,18841963456,5252313
18847216151,168,13,receive,18841929179,5286972
18847216667,176,10,receive,18842060906,5155761
18847217165,164,14,receive,18841982610,5234555
18847217540,162,22,receive,18842010187,5207353
18847218102,114,23,receive,18842029271,5188831
18847218491,182,9,receive,18841929410,5289081
18847268120,124,12,receive,18842063318,5204802
18847268530,40,16,receive,18842063880,5204650
18847268978,56,18,receive,18841917436,5351542
18847269484,60,15,receive,18842065425,5204059
18847270445,110,12,receive,18842065508,5204937
18847271032,80,24,receive,18842038973,5232059
18847271488,192,14,receive,18842066252,5205236
18847271870,112,20,receive,18842067889,5203981
18847272426,120,27,receive,18842015735,5256691
18847272909,194,9,receive,18842069260,5203649
18847311843,166,8,receive,18841839168,5472675
18847312275,62,10,receive,18842070271,5242004
18847312646,52,23,receive,18842047317,5265329
18847313066,168,14,receive,18842070226,5242840
18847313460,22,20,receive,18841999764,5313696
18847313869,60,16,receive,18842074645,5239224
18847314245,2,11,receive,18842046072,5268173
18847314627,70,16,receive,18841983771,5330856
18847315046,102,15,receive,18842076090,5238956
18847315425,70,17,receive,18842077266,5238159
18847315802,130,16,receive,18841997449,5318353
18847316188,94,13,receive,18842078299,5237889
18847316562,172,15,receive,18842049544,5267018
18847316977,170,15,receive,18842008698,5308279
18847317356,76,27,receive,18841986718,5330638
18847317726,104,16,receive,18842030605,5287121
18847360142,102,16,receive,18842081299,5278843
18847360835,62,11,receive,18842081481,5279354
18847361283,52,24,receive,18842081899,5279384
18847361679,50,8,receive,18842082678,5279001
18847362245,134,19,receive,18842000078,5362167
18847362622,110,13,receive,18842083699,5278923
18847363593,190,14,receive,18842034219,5329374
18847364169,126,16,receive,18842015725,5348444
18847364572,52,25,receive,18842085076,5279496
18847364962,52,26,receive,18842085197,5279765
18847365390,22,21,receive,18842084881,5280509
18847365846,96,30,receive,18841932029,5433817
18847366244,82,10,receive,18842059329,5306915
18847391283,152,14,receive,18842072276,5319007
18847393199,68,18,receive,18842046043,5347156
18847395191,58,7,receive,18842084514,5310677
18847396819,52,27,receive,18842089359,5307460
18847398798,26,19,receive,18842049598,5349200
18847400721,8,16,receive,18841928395,5472326
18847402278,150,19,receive,18842011938,5390340
18847404509,128,17,receive,18842075624,5328885
18847407231,24,16,receive,18842044543,5362688
18847408959,28,28,receive,18842015290,5393669
18847411271,142,14,receive,18841939534,5471737
18847413726,122,20,receive,18842057190,5356536
18847416025,8,17,receive,18842093987,5322038
18847419642,12,12,receive,18842046293,5373349
18847422472,166,9,receive,18842096031,5326441
18847424595,166,10,receive,18842097238,5327357
18847427106,84,15,receive,18842046216,5380890
18847430980,156,10,receive,18842001057,5429923
18847435477,166,11,receive,18842100437,5335040
18847437684,88,13,receive,18842003710,5433974
18847440151,144,12,receive,18841928389,5511762
18847442603,6,16,receive,18842027864,5414739
18847444962,72,7,receive,18842053919,5391043
18847447446,112,21,receive,18842103271,5344175
18847450158,162,23,receive,18842098750,5351408
18847452736,110,14,receive,18842106916,5345820
18847455131,162,24,receive,18842106505,5348626
18847457679,102,17,receive,18842107624,5350055
18847462110,62,12,receive,18842107708,5354402
18847465914,138,14,receive,18842019260,5446654
18847468638,24,17,receive,18842107868,5360770
18847469878,56,19,receive,18842107559,5362319
18847472074,44,13,receive,18842098498,5373576
18847474724,120,28,receive,18842084177,5390547
18847477651,44,14,receive,18842109059,5368592
18847480380,20,8,receive,18842084257,5396123
18847483080,50,9,receive,18842110011,5373069
18847485635,158,22,receive,18841943034,5542601
18847488462,192,15,receive,18842113710,5374752
18847489692,166,12,receive,18842113719,5375973
18847492495,56,20,receive,18842113897,5378598
18847494406,42,24,receive,18842025843,5468563
18847497148,156,11,receive,18842115310,5381838
18847499121,160,5,receive,18842030467,5468654
18847501066,136,21,receive,18842101785,5399281
18847502887,78,18,receive,18842075349,5427538
18847504862,30,14,receive,18842033796,5471066
18847506992,86,21,receive,18842060789,5446203
18847508970,196,7,receive,18842086189,5422781
18847511460,18,4,receive,18841885549,5625911
18847513598,12,13,receive,18842120173,5393425
18847515589,186,23,receive,18842039804,5475785
18847519097,118,28,receive,18841913330,5605767
18847520377,18,5,receive,18842121219,5399158
18847522252,2,12,receive,18842084988,5437264
18847524446,178,14,receive,18842064726,5459720
18847526330,138,15,receive,18842123902,5402428
18847528389,34,25,receive,18842060768,5467621
18847530464,168,15,receive,18842077460,5453004
18847533879,114,24,receive,18842106993,5426886
18847535511,66,13,receive,18841971668,5563843
18847538113,192,16,receive,18842130993,5407120
18847540044,4,17,receive,18842071965,5468079
18847541716,184,16,receive,18842038374,5503342
18847551517,10,13,receive,18842063961,5487556
18847553611,156,12,receive,18842132549,5421062
18847554829,90,15,receive,18842105261,5449568
18847556972,122,21,receive,18842100453,5456519
18847559099,126,17,receive,18842133429,5425670
18847561309,130,17,receive,18842120107,5441202
18847564220,54,16,receive,18841933778,5630442
18847569044,128,18,receive,18842113550,5455494
18847569824,174,14,receive,18842056134,5513690
18847571322,180,17,receive,18842102665,5468657
18847575304,134,20,receive,18842103278,5472026
18847576930,172,16,receive,18842096480,5480450
18847579343,22,22,receive,18842125196,5454147
18847580510,140,38,receive,18842050074,5530436
18847586410,166,13,receive,18842138065,5448345
18847590020,170,16,receive,18842110188,5479832
18847591209,198,8,receive,18842035770,5555439
18847596371,104,17,receive,18842117426,5478945
18847597846,70,18,receive,18842122646,5475200
18847599211,194,10,receive,18842107557,5491654
18847609465,46,19,receive,18842062751,5546714
18847609906,40,17,receive,18842093259,5516647
18847610303,50,10,receive,18842148379,5461924
18847610730,36,25,receive,18842087217,5523513
18847611116,110,15,receive,18842149220,5461896
18847611491,192,17,receive,18842149246,5462245
18847611869,120,29,receive,18842147261,5464608
18847612243,116,18,receive,18842095070,5517173
18847612734,20,9,receive,18842149612,5463122
18847613109,148,9,receive,18842071389,5541720
18847613480,48,20,receive,18842072212,5541268
18847613852,102,18,receive,18842153119,5460733
18847639471,188,13,receive,18842074935,5564536
18847640822,152,15,receive,18842135410,5505412
18847641273,90,16,receive,18842138209,5503064
18847641670,106,17,receive,18842036356,5605314
18847642883,90,17,receive,18842154760,5488123
18847643290,38,21,receive,18842089403,5553887
18847643674,94,14,receive,18842098581,5545093
18847682099,62,13,receive,18842158094,5524005
18847682519,6,17,receive,18842139142,5543377
18847682967,58,8,receive,18842110384,5572583
18847683349,88,14,receive,18842136694,5546655
18847683720,154,18,receive,18841960272,5723448
18847684088,126,18,receive,18842159867,5524221
18847684488,146,20,receive,18842074867,5609621
18847684875,98,14,receive,18841999179,5685696
18847685239,124,13,receive,18842097582,5587657
18847685604,82,11,receive,18842136037,5549567
18847706052,158,23,receive,18842133461,5572591
18847706827,12,14,receive,18842131441,5575386
18847711377,160,6,receive,18842164456,5546921
18847713156,100,22,receive,18842078289,5634867
18847715270,80,25,receive,18842072798,5642472
18847717514,126,19,receive,18842166122,5551392
18847719132,178,15,receive,18842131063,5588069
18847720707,188,14,receive,18842166424,5554283
18847727813,96,31,receive,18842122657,5605156
18847732610,108,7,receive,18842077978,5654632
18847734182,76,28,receive,18842127535,5606647
18847737506,24,18,receive,18842148280,5589226
18847740968,186,24,receive,18842133661,5607307
18847742313,68,19,receive,18842132982,5609331
18847744465,182,10,receive,18842091827,5652638
18847747336,148,10,receive,18842170108,5577228
18847749327,26,20,receive,18842116787,5632540
18847751388,30,15,receive,18842145287,5606101
18847757347,138,16,receive,18842137414,5619933
18847760214,102,19,receive,18842173413,5586801
18847765131,2,13,receive,18842156200,5608931
18847768192,168,16,receive,18842141678,5626514
18847769685,148,11,receive,18842175307,5594378
18847772195,28,29,receive,18842118391,5653804
18847774415,52,28,receive,18842134623,5639792
18847776376,18,6,receive,18842177125,5599251
18847779630,188,15,receive,18842177631,5601999
18847781594,62,14,receive,18842178311,5603283
18847783708,200,6,receive,18841872347,5911361
18847787499,64,19,receive,18842077130,5710369
18847789546,172,17,receive,18842167484,5622062
18847792405,20,10,receive,18842174303,5618102
18847795515,86,22,receive,18842155887,5639628
18847798538,182,11,receive,18842181240,5617298
18847800414,160,7,receive,18842181682,5618732
18847803210,156,13,receive,18842181973,5621237
18847807390,54,17,receive,18842150212,5657178
18847809861,144,15,receive,18842264388,5545473
18847815761,90,20,receive,18842310172,5505589
18847817576,140,41,receive,18842273360,5544216
18847821619,118,31,receive,18842269759,5551860
18847824044,62,16,receive,18842279093,5544951
18847826221,184,19,receive,18842259761,5566460
18847834149,96,34,receive,18842301367,5532782
18847836341,114,27,receive,18842290515,5545826
18847840204,36,30,receive,18842312287,5527917
18847842082,152,17,receive,18842269540,5572542
18847853914,56,23,receive,18842270833,5583081
18847856939,104,20,receive,18842307520,5549419
18847859317,94,17,receive,18842305708,5553609
18847890601,58,12,receive,18842324303,5566298
18847891010,46,25,receive,18842346897,5544113
18847891433,50,21,receive,18842355174,5536259
18847891852,186,29,receive,18842354303,5537549
18847892230,68,23,receive,18842329576,5562654
18847892658,194,14,receive,18842339610,5553048
18847893034,128,23,receive,18842356188,5536846
18847893440,118,32,receive,18842338468,5554972
18847893832,10,17,receive,18842341263,5552569
18847894218,62,17,receive,18842343177,5551041
18847897795,28,32,receive,18842344616,5553179
18847898187,96,35,receive,18842332632,5565555
18847898564,56,24,receive,18842330282,5568282
18847899199,88,17,receive,18842337959,5561240
18847899591,148,15,receive,18842403130,5496461
18847931376,136,26,receive,18842376619,5554757
18847933007,68,24,receive,18842370923,5562084
18847935075,30,19,receive,18842369032,5566043
18847936170,18,9,receive,18842331705,5604465
18847957652,46,26,receive,18842374349,5583303
18847960245,108,11,receive,18842386501,5573744
18847963483,116,24,receive,18842381240,5582243
18847965790,88,18,receive,18842406757,5559033
18847967698,194,15,receive,18842374611,5593087
18847970540,122,26,receive,18842360976,5609564
18847973129,36,32,receive,18842376735,5596394
18847975490,140,43,receive,18842368446,5607044
18847978118,130,24,receive,18842396036,5582082
18847983571,38,27,receive,18842431329,5552242
18847985559,136,27,receive,18842414428,5571131
18847987536,24,26,receive,18842428781,5558755
18847991065,46,27,receive,18842456541,5534524
18847993098,140,44,receive,18842449636,5543462
18847995314,92,17,receive,18842448560,5546754
18847998938,68,25,receive,18842421988,5576950
18848000510,130,25,receive,18842443008,5557502
18848002023,24,27,receive,18842463193,5538830
18848004041,48,25,receive,18842419635,5584406
18848006768,70,24,receive,18842464167,5542601
18848014692,126,24,receive,18842440849,5573843
18848017705,178,21,receive,18842466420,5551285
18848020177,118,35,receive,18842514514,5505663
18848023869,152,21,receive,18842515413,5508456
18848027523,46,28,receive,18842484770,5542753
18848030752,168,22,receive,18842470665,5560087
18848033575,126,25,receive,18842499677,5533898
18848036727,78,24,receive,18842471591,5565136
18848039404,54,25,receive,18842513319,5526085
18848045013,68,26,receive,18842512797,5532216
18848047167,48,26,receive,18842474738,5572429
18848049405,174,20,receive,18842467678,5581727
18848051943,156,20,receive,18842519253,5532690
18848053964,144,20,receive,18842516581,5537383
18848055923,74,16,receive,18842481765,5574158
18848058932,122,29,receive,18842554060,5504872
18848060142,8,24,receive,18842533613,5526529
18848062077,198,15,receive,18842516111,5545966
18848064287,152,22,receive,18842564689,5499598
18848066278,88,22,receive,18842559323,5506955
18848067880,116,27,receive,18842546631,5521249
18848070792,174,21,receive,18842565770,5505022
18848072901,90,24,receive,18842545295,5527606
18848075662,178,22,receive,18842563139,5512523
18848077379,158,32,receive,18842551779,5525600
18848079584,94,23,receive,18842526437,5553147
18848083116,46,29,receive,18842558896,5524220
18848085880,146,27,receive,18842589459,5496421
18848089255,60,26,receive,18842567096,5522159
18848104579,24,30,receive,18842602907,5501672
18848104947,98,19,receive,18842561326,5543621
18848105335,40,27,receive,18842591584,5513751
18848105777,70,27,receive,18842577210,5528567
18848106153,2,21,receive,18842594021,5512132
18848106521,134,29,receive,18842582361,5524160
18848106890,4,25,receive,18842577935,5528955
18848107264,152,23,receive,18842577094,5530170
18848107740,156,21,receive,18842565939,5541801
18848108148,140,48,receive,18842649801,5458347
18848108526,36,38,receive,18842654260,5454266
18848133309,112,31,receive,18842650013,5483296
18848133895,88,23,receive,18842617735,5516160
18848134427,20,21,receive,18842656384,5478043
18848134933,24,31,receive,18842629542,5505391
18848135377,156,22,receive,18842624633,5510744
18848135829,70,28,receive,18842626435,5509394
18848136209,60,27,receive,18842658467,5477742
18848136587,134,30,receive,18842620286,5516301
18848136957,2,22,receive,18842616782,5520175
18848137327,64,28,receive,18842654000,5483327
18848137742,164,21,receive,18842587207,5550535
18848167190,60,28,receive,18842673535,5493655
18848167604,98,21,receive,18842691106,5476498
18848167988,70,29,receive,18842691135,5476853
18848168376,26,30,receive,18842669621,5498755
18848168754,10,25,receive,18842677650,5491104
18848169161,158,36,receive,18842675987,5493174
18848169572,100,32,receive,18842668662,5500910
18848169948,2,23,receive,18842685183,5484765
18848170327,134,31,receive,18842687055,5483272
18848170691,90,27,receive,18842689845,5480846
18848171108,152,25,receive,18842705689,5465419
18848171491,106,31,receive,18842760263,5411228
18848191799,90,28,receive,18842730911,5460888
18848193737,146,30,receive,18842751382,5442355
18848195325,18,14,receive,18842680121,5515204
18848196972,194,23,receive,18842734999,5461973
18848198485,152,26,receive,18842741173,5457312
18848201114,4,28,receive,18842745339,5455775
18848203571,92,25,receive,18842736873,5466698
18848206962,66,24,receive,18842727107,5479855
18848210400,26,31,receive,18842737978,5472422
18848212454,178,26,receive,18842732213,5480241
18848214681,152,27,receive,18842767125,5447556
18848217263,100,33,receive,18842729628,5487635
18848229646,196,20,receive,18842725148,5504498
18848230047,156,25,receive,18842767148,5462899
18848230519,74,22,receive,18842800285,5430234
18848230884,4,32,receive,18842815785,5415099
18848231246,26,32,receive,18842812063,5419183
18848231614,100,34,receive,18842817178,5414436
18848231973,156,26,receive,18842817477,5414496
18848232361,178,27,receive,18842798142,5434219
18848232929,172,29,receive,18842798658,5434271
18848233370,196,21,receive,18842793953,5439417
18848233772,130,32,receive,18842814562,5419210
18848234171,152,28,receive,18842801506,5432665
18848278085,12,28,receive,18842795957,5482128
18848278572,92,26,receive,18842792874,5485698
18848279036,168,28,receive,18842810722,5468314
18848279449,178,28,receive,18842863849,5415600
18848279898,4,34,receive,18842868617,5411281
18848280933,130,33,receive,18842862038,5418895
18848281406,172,30,receive,18842849962,5431444
18848281953,92,28,receive,18842854432,5427521
18848282482,152,29,receive,18842833107,5449375
18848282865,178,29,receive,18842871359,5411506
18848283293,56,36,receive,18842845534,5437759
18848283743,26,33,receive,18842863216,5420527
18848284238,38,35,receive,18842849564,5434674
18848318968,186,39,receive,18842865497,5453471
18848319434,120,42,receive,18842854002,5465432
18848320107,130,34,receive,18842920508,5399599
18848320560,192,31,receive,18842909263,5411297
18848320944,164,24,receive,18842862578,5458366
18848321397,194,25,receive,18842876191,5445206
18848321780,180,31,receive,18842913779,5408001
18848322155,92,29,receive,18842918972,5403183
18848322529,12,31,receive,18842891131,5431398
18848322905,38,36,receive,18842887503,5435402
18848323369,38,37,receive,18842925475,5397894
18848323744,120,43,receive,18842888084,5435660
18848324115,172,31,receive,18842887879,5436236
18848324490,28,42,receive,18842875241,5449249
18848324868,56,38,receive,18842908672,5416196
18848325299,108,23,receive,18842931273,5394026
18848325699,180,32,receive,18842942220,5383479
18848345244,112,38,receive,18842958922,5386322
18848347201,98,26,receive,18842948803,5398398
18848351586,160,25,receive,18842940514,5411072
18848352682,16,27,receive,18842956414,5396268
18848359000,132,35,receive,18842947390,5411610
18848360298,76,44,receive,18842931199,5429099
18848362160,92,30,receive,18842966198,5395962
18848364160,98,27,receive,18842977069,5387091
18848366125,38,38,receive,18842973792,5392333
18848367983,152,31,receive,18842977835,5390148
18848369867,64,34,receive,18842951341,5418526
18848373175,156,30,receive,18842970451,5402724
18848375230,38,39,receive,18843026533,5348697
18848380142,76,46,receive,18842993159,5386983
18848382721,44,33,receive,18843029213,5353508
18848384283,180,33,receive,18843007662,5376621
18848386626,152,32,receive,18843025645,5360981
18848389393,186,43,receive,18843017008,5372385
18848392301,160,26,receive,18843012127,5380174
18848394107,56,40,receive,18843016171,5377936
18848395676,172,33,receive,18843031330,5364346
18848397617,36,45,receive,18842985759,5411858
18848399332,26,36,receive,18842990263,5409069
18848401963,52,45,receive,18843034438,5367525
18848403595,76,47,receive,18843076791,5326804
18848405401,12,34,receive,18843052119,5353282
18848409093,46,42,receive,18843058355,5350738
18848411147,86,38,receive,18843059901,5351246
18848412822,196,26,receive,18843047423,5365399
18848414880,36,47,receive,18843051312,5363568
18848417034,160,27,receive,18843083656,5333378
18848418281,52,46,receive,18843078033,5340248
18848421910,40,36,receive,18843068444,5353466
18848423819,62,32,receive,18843074594,5349225
18848426109,62,33,receive,18843085836,5340273
18848428537,182,31,receive,18843082171,5346366
18848430539,180,34,receive,18843056742,5373797
18848432418,48,37,receive,18843110444,5321974
18848434072,62,34,receive,18843095943,5338129
18848438234,50,36,receive,18843079299,5358935
18848439041,162,43,receive,18843119181,5319860
18848446217,50,37,receive,18843133909,5312308
18848448339,196,27,receive,18843100835,5347504
18848451713,132,38,receive,18843097041,5354672
18848453302,52,47,receive,18843121903,5331399
18848455088,182,32,receive,18843112119,5342969
18848473571,196,28,receive,18843135377,5338194
18848476001,118,46,receive,18843105950,5370051
18848477215,18,20,receive,18843083733,5393482
18848478736,6,36,receive,18843179361,5299375
18848480408,120,49,receive,18843151056,5329352
18848482417,12,36,receive,18843158767,5323650
18848490466,160,29,receive,18843176886,5313580
18848492066,76,49,receive,18843150441,5341625
18848494600,182,33,receive,18843180560,5314040
18848496166,44,35,receive,18843155100,5341066
18848497350,18,21,receive,18843155665,5341685
18848498497,86,40,receive,18843146703,5351794
18848500119,12,37,receive,18843182454,5317665
18848504682,46,44,receive,18843179529,5325153
18848505936,76,50,receive,18843183675,5322261
18848507111,122,43,receive,18843177399,5329712
18848508410,130,40,receive,18843186891,5321519
18848509192,156,34,receive,18843218786,5290406
18848510334,120,50,receive,18843209359,5300975
18848511483,196,30,receive,18843222544,5288939
18848512651,132,41,receive,18843192752,5319899
18848513823,182,34,receive,18843220090,5293733
18848514975,194,31,receive,18843205286,5309689
18848516823,12,38,receive,18843216661,5300162
18848518855,76,51,receive,18843185953,5332902
18848521373,62,36,receive,18843188749,5332624
18848523107,18,22,receive,18843214174,5308933
18848524673,46,46,receive,18843256656,5268017
18848526865,74,33,receive,18843274244,5252621
18848528824,132,42,receive,18843238186,5290638
18848531330,126,37,receive,18843228907,5302423
18848533368,114,47,receive,18843244659,5288709
18848535528,130,41,receive,18843236965,5298563
18848537988,88,36,receive,18843272942,5265046
18848540182,160,30,receive,18843230638,5309544
18848542709,18,23,receive,18843279344,5263365
18848545814,114,48,receive,18843325738,5220076
18848548074,112,46,receive,18843328679,5219395
18848549439,58,33,receive,18843298927,5250512
18848550836,120,52,receive,18843327017,5223819
18848553026,12,40,receive,18843321129,5231897
18848555064,182,37,receive,18843297182,5257882
18848557268,76,53,receive,18843303233,5254035
18848559937,60,40,receive,18843309909,5250028
18848561741,30,36,receive,18843279437,5282304
18848564457,4,44,receive,18843327572,5236885
18848566468,88,37,receive,18843283046,5283422
18848568556,196,32,receive,18843321019,5247537
18848570168,68,43,receive,18843332731,5237437
18848572671,58,34,receive,18843356659,5216012
18848574290,128,44,receive,18843375961,5198329
18848576381,194,34,receive,18843345806,5230575
18848579009,134,43,receive,18843363862,5215147
18848582693,74,35,receive,18843376922,5205771
18848584678,196,33,receive,18843373798,5210880
18848587336,144,36,receive,18843338149,5249187
18848590083,164,30,receive,18843365071,5225012
18848591751,72,31,receive,18843336710,5255041
18848598291,60,41,receive,18843358982,5239309
18848603588,76,54,receive,18843362845,5240743
18848605866,144,37,receive,18843408879,5196987
18848607029,146,42,receive,18843381264,5225765
18848610488,134,44,receive,18843409252,5201236
18848612042,74,36,receive,18843387736,5224306
18848614564,78,40,receive,18843382771,5231793
18848617038,76,55,receive,18843398605,5218433
18848619147,68,44,receive,18843409380,5209767
18848624076,120,55,receive,18843432679,5191397
18848628543,196,34,receive,18843422029,5206514
18848630434,20,37,receive,18843421010,5209424
18848633549,72,32,receive,18843427749,5205800
18848634966,72,33,receive,18843435313,5199653
18848636192,182,39,receive,18843402879,5233313
18848637315,196,35,receive,18843466107,5171208
18848638424,76,56,receive,18843473824,5164600
18848640256,146,44,receive,18843442838,5197418
18848642478,134,45,receive,18843444301,5198177
18848645787,20,38,receive,18843458313,5187474
18848648864,54,46,receive,18843467345,5181519
18848650048,8,41,receive,18843451689,5198359
18848652229,78,41,receive,18843453402,5198827
18848654597,50,44,receive,18843485937,5168660
18848656255,182,40,receive,18843453873,5202382
18848659454,12,43,receive,18843481949,5177505
18848661027,130,45,receive,18843463191,5197836
18848680404,72,34,receive,18843476710,5203694
18848680786,196,36,receive,18843514757,5166029
18848687915,108,33,receive,18843419547,5268368
18848688299,50,45,receive,18843518380,5169919
18848689329,112,51,receive,18843526362,5162967
18848689748,42,55,receive,18843522318,5167430
18848690157,130,46,receive,18843517338,5172819
18848690557,182,41,receive,18843530406,5160151
18848690982,146,45,receive,18843528750,5162232
18848691762,134,46,receive,18843492229,5199533
18848692511,52,56,receive,18843495482,5197029
18848694392,144,40,receive,18843486389,5208003
18848697906,72,35,receive,18843494423,5203483
18848700035,26,48,receive,18843580007,5120028
18848701234,182,42,receive,18843561948,5139286
18848708030,130,48,receive,18843569257,5138773
18848710934,110,45,receive,18843564256,5146678
18848711708,10,42,receive,18843580673,5131035
18848712972,10,43,receive,18843590964,5122008
18848723001,52,57,receive,18843552121,5170880
18848724151,68,47,receive,18843548227,5175924
18848725376,72,36,receive,18843549193,5176183
18848726742,146,46,receive,18843568563,5158179
18848727997,152,43,receive,18843568748,5159249
18848729566,158,56,receive,18843561638,5167928
18848732513,144,43,receive,18843632742,5099771
18848734100,10,44,receive,18843623157,5110943
18848736523,76,59,receive,18843601682,5134841
18848738127,50,47,receive,18843621942,5116185
18848739274,42,57,receive,18843633404,5105870
18848745225,26,49,receive,18843620702,5124523
18848746502,68,48,receive,18843628256,5118246
18848748666,152,44,receive,18843631839,5116827
18848751505,130,49,receive,18843608514,5142991
18848754867,168,44,receive,18843605624,5149243
18848755654,60,48,receive,18843612606,5143048
18848756875,170,46,receive,18843634545,5122330
18848758030,152,45,receive,18843687202,5070828
18848761102,28,57,receive,18843680187,5080915
18848766151,186,56,receive,18843661592,5104559
18848788440,150,53,receive,18843652180,5136260
18848790750,180,47,receive,18843697699,5093051
18848792797,2,41,receive,18843674383,5118414
18848794034,20,42,receive,18843674162,5119872
18848795667,56,54,receive,18843678431,5117236
18848797091,60,49,receive,18843695569,5101522
18848799424,30,44,receive,18843693343,5106081
18848801729,44,46,receive,18843657963,5143766
18848802953,156,43,receive,18843748414,5054539
18848803747,172,46,receive,18843723878,5079869
18848806750,60,50,receive,18843715282,5091468
18848807927,44,47,receive,18843739775,5068152
18848809895,10,46,receive,18843713899,5095996
18848811831,46,57,receive,18843750230,5061601
18848813439,26,51,receive,18843712698,5100741
18848815650,42,60,receive,18843726817,5088833
18848817196,170,48,receive,18843748772,5068424
18848819202,14,46,receive,18843733300,5085902
18848823517,44,48,receive,18843752759,5070758
18848825369,138,48,receive,18843708209,5117160
18848826517,44,49,receive,18843790340,5036177
18848828216,194,44,receive,18843767563,5060653
18848830276,126,45,receive,18843748705,5081571
18848831835,42,62,receive,18843802955,5028880
18848836028,150,55,receive,18843774294,5061734
18848837919,112,56,receive,18843772872,5065047
18848841414,2,43,receive,18843801966,5039448
18848842668,14,47,receive,18843787438,5055230
18848843929,160,40,receive,18843777187,5066742
18848845185,192,49,receive,18843793361,5051824
18848846862,84,49,receive,18843776909,5069953
18848848439,26,52,receive,18843780284,5068155
18848850410,72,40,receive,18843759328,5091082
18848855400,144,46,receive,18843758191,5097209
18848856187,66,47,receive,18843818963,5037224
18848857891,46,59,receive,18843839083,5018808
18848860375,150,56,receive,18843845762,5014613
18848862263,192,50,receive,18843828766,5033497
18848863853,126,46,receive,18843820703,5043150
18848865846,136,53,receive,18843852833,5013013
18848867980,134,52,receive,18843857055,5010925
18848869147,160,41,receive,18843836624,5032523
18848871653,190,33,receive,18843777953,5093700
18848873233,10,48,receive,18843842929,5030304
18848874789,72,41,receive,18843824967,5049822
18848878272,170,50,receive,18843818131,5060141
18848879858,112,58,receive,18843890367,4989491
18848881009,160,42,receive,18843895957,4985052
18848884227,118,60,receive,18843886638,4997589
18848884992,134,53,receive,18843872183,5012809
18848886585,134,54,receive,18843908982,4977603
18848889837,162,59,receive,18843907085,4982752
18848891462,126,47,receive,18843897555,4993907
18848893895,170,51,receive,18843888607,5005288
18848895538,46,60,receive,18843871343,5024195
18848900051,122,56,receive,18843895944,5004107
18848901579,8,48,receive,18843875359,5026220
18848903865,46,61,receive,18843910703,4993162
18848905490,192,51,receive,18843871732,5033758
18848906277,46,62,receive,18843948536,4957741
18848907883,134,56,receive,18843947525,4960358
18848910091,160,43,receive,18843913732,4996359
18848911842,170,52,receive,18843936695,4975147
18848915905,122,57,receive,18843923663,4992242
18848917512,110,53,receive,18843935074,4982438
18848920723,44,52,receive,18843938723,4982000
18848921818,150,58,receive,18843949919,4971899
18848924942,126,48,receive,18843929315,4995627
18848926482,84,52,receive,18843920626,5005856
18848928472,174,49,receive,18843960870,4967602
18848930203,118,61,receive,18843955476,4974727
18848933043,144,49,receive,18843972268,4960775
18848934737,170,53,receive,18843992518,4942219
18848936343,84,53,receive,18843996297,4940046
18848939072,160,44,receive,18843978269,4960803
18848944287,64,55,receive,18844014294,4929993
18848945767,98,51,receive,18843999025,4946742
18848947759,112,60,receive,18843984513,4963246
18848950642,34,66,receive,18844006647,4943995
18848951853,84,54,receive,18844015104,4936749
18848954229,184,51,receive,18844002273,4951956
18848955871,170,54,receive,18844015896,4939975
18848957487,24,58,receive,18844004693,4952794
18848960159,140,76,receive,18844000999,4959160
18848961686,156,51,receive,18844043498,4918188
18848964116,114,62,receive,18844028756,4935360
18848965666,34,67,receive,18844019496,4946170
18848968580,132,59,receive,18844061671,4906909
18848970166,140,77,receive,18844032200,4937966
18848971883,64,56,receive,18844053506,4918377
18848973948,112,61,receive,18844020155,4953793
18848976102,144,50,receive,18844019056,4957046
18848977255,90,54,receive,18844042237,4935018
18848979817,2,48,receive,18844030856,4948961
18848981469,142,52,receive,18844030827,4950642
18848983449,116,57,receive,18844107556,4875893
18848985493,122,60,receive,18844119854,4865639
18848987355,64,57,receive,18844119690,4867665
18848991904,144,51,receive,18844075660,4916244
18848993473,196,50,receive,18844096904,4896569
18848995063,36,67,receive,18844085509,4909554
18848997639,70,60,receive,18844094231,4903408
18848999220,178,56,receive,18844086802,4912418
18849001329,120,69,receive,18844101331,4899998
18849004048,16,41,receive,18844019204,4984844
18849006145,20,50,receive,18844127620,4878525
18849007844,166,50,receive,18844087780,4920064
18849009773,32,42,receive,18844109412,4900361
18849012210,2,50,receive,18844170883,4841327
18849013732,126,50,receive,18844092007,4921725
18849015734,136,60,receive,18844136374,4879360
18849016868,178,57,receive,18844179358,4837510
18849018814,158,68,receive,18844141280,4877534
18849037538,132,61,receive,18844163694,4873844
18849039227,20,51,receive,18844139262,4899965
18849041251,164,41,receive,18844128723,4912528
18849066270,166,51,receive,18844169963,4896307
18849067977,22,64,receive,18844155013,4912964
18849069579,54,60,receive,18844163215,4906364
18849080310,78,55,receive,18844185648,4894662
18849085052,106,60,receive,18844214481,4870571
18849087418,142,55,receive,18844196936,4890482
18849089794,178,58,receive,18844226684,4863110
18849091917,120,71,receive,18844200195,4891722
18849094516,116,59,receive,18844194048,4900468
18849096671,2,51,receive,18844203771,4892900
18849098626,22,65,receive,18844194151,4904475
18849100655,144,53,receive,18844193375,4907280
18849102576,78,56,receive,18844229097,4873479
18849104482,86,60,receive,18844180458,4924024
18849106384,158,69,receive,18844186618,4919766
18849109665,142,56,receive,18844251880,4857785
18849110899,198,48,receive,18844261522,4849377
18849114566,116,60,receive,18844259782,4854784
18849115792,128,62,receive,18844245711,4870081
18849117238,88,54,receive,18844262364,4854874
18849120237,18,36,receive,18844227821,4892416
18849121851,36,70,receive,18844248376,4873475
18849123474,196,53,receive,18844243806,4879668
18849128776,70,63,receive,18844236088,4892688
18849129586,78,57,receive,18844238389,4891197
18849133723,158,70,receive,18844247720,4886003
18849135400,40,61,receive,18844281372,4854028
18849137044,166,53,receive,18844262004,4875040
18849139549,2,52,receive,18844244664,4894885
18849143989,54,62,receive,18844253847,4890142
18849145397,158,71,receive,18844330956,4814441
18849146860,70,64,receive,18844309582,4837278
18849148834,64,61,receive,18844315979,4832855
18849150411,68,60,receive,18844327108,4823303
18849152787,128,63,receive,18844327133,4825654
18849153987,78,58,receive,18844302351,4851636
18849155026,166,54,receive,18844335591,4819435
18849159505,96,74,receive,18844312111,4847394
18849161231,38,52,receive,18843535068,5626163
18849162841,88,55,receive,18844319247,4843594
18849164714,6,60,receive,18844305598,4859116
18849167399,4,67,receive,18844331144,4836255
18849168536,70,65,receive,18844340555,4827981
18849170580,198,50,receive,18844356552,4814028
18849172162,166,55,receive,18844379055,4793107
18849174742,42,74,receive,18844367167,4807575
18849176721,38,53,receive,18844374811,4801910
18849178701,88,56,receive,18844347299,4831402
18849180653,30,59,receive,18844368382,4812271
18849183278,124,59,receive,18844349206,4834072
18849184919,78,59,receive,18844366488,4818431
18849186904,168,59,receive,18844356182,4830722
18849188880,154,63,receive,18844365166,4823714
18849190842,128,64,receive,18844365423,4825419
18849192263,184,58,receive,18844387050,4805213
18849194086,184,59,receive,18844407331,4786755
18849196118,92,58,receive,18844415175,4780943
18849197691,88,57,receive,18844424829,4772862
18849199618,110,63,receive,18844408366,4791252
18849201982,58,56,receive,18844400772,4801210
18849203656,58,57,receive,18844445845,4757811
18849205742,182,61,receive,18844428459,4777283
18849208067,154,64,receive,18844442563,4765504
18849209818,40,64,receive,18844403366,4806452
18849212503,194,56,receive,18844428078,4784425
18849214788,52,74,receive,18844436599,4778189
18849216856,66,61,receive,18844444141,4772715
18849218425,180,62,receive,18844468366,4750059
18849221287,64,64,receive,18844490309,4730978
18849223223,188,58,receive,18844453636,4769587
18849224715,168,61,receive,18844492432,4732283
18849226848,128,66,receive,18844443975,4782873
18849228821,198,52,receive,18844447190,4781631
18849230887,184,60,receive,18844448548,4782339
18849232871,92,59,receive,18844462182,4770689
18849235995,104,66,receive,18844484741,4751254
18849237581,58,58,receive,18844494065,4743516
18849239202,116,64,receive,18844453692,4785510
18849240807,124,63,receive,18844480610,4760197
18849242375,158,75,receive,18844533887,4708488
18849246602,82,61,receive,18844533688,4712914
18849248501,186,72,receive,18844508434,4740067
18849252297,128,67,receive,18844517935,4734362
18849253432,64,65,receive,18844532718,4720714
18849254629,166,58,receive,18844494945,4759684
18849255829,176,55,receive,18844496784,4759045
18849257134,180,63,receive,18844522772,4734362
18849258762,58,59,receive,18844534540,4724222
18849260849,12,64,receive,18844528300,4732549
18849262874,18,39,receive,18844472635,4790239
18849265018,116,65,receive,18844509497,4755521
18849266596,100,71,receive,18844538759,4727837
18849269065,166,59,receive,18844552366,4716699
18849273103,146,66,receive,18844555978,4717125
18849275108,58,60,receive,18844581478,4693630
18849277189,174,61,receive,18844576063,4701126
18849279359,4,73,receive,18844561358,4718001
18849281410,18,40,receive,18844586671,4694739
18849284699,164,46,receive,18844542927,4741772
18849286311,110,65,receive,18844549605,4736706
18849288206,176,56,receive,18844593752,4694454
18849290929,12,65,receive,18844575205,4715724
18849292611,174,62,receive,18844627698,4664913
18849294603,184,62,receive,18844615846,4678757
18849296872,4,74,receive,18844600590,4696282
18849302054,170,68,receive,18844630433,4671621
18849303526,82,63,receive,18844604170,4699356
