receive_timestamp,source_vehicle,message_id,event_type,send_timestamp,latency_us
373374903,12,3,receive,373259914,114989
373375336,32,2,receive,373250011,125325
373375735,92,1,receive,373260118,115617
373376130,104,1,receive,373260181,115949
373376573,114,2,receive,373260429,116144
373376986,172,1,receive,373260499,116487
373379761,66,6,receive,373256207,123554
373769978,144,1,receive,373260632,509346
373770408,8,4,receive,373257755,512653
373770817,112,1,receive,373262148,508669
373771228,40,4,receive,373262494,508734
373771642,206,1,receive,373262711,508931
373772073,96,1,receive,373262913,509160
373772486,150,1,receive,373264523,507963
373773324,208,2,receive,373264969,508355
373773948,14,6,receive,373264854,509094
373774420,590,1,receive,373266097,508323
373870437,14,7,receive,373267806,602631
373870948,140,1,receive,373270021,600927
373871508,22,1,receive,373270029,601479
373871970,18,1,receive,373270036,601934
373872418,202,2,receive,373270712,601706
373872863,60,1,receive,373270683,602180
373873305,160,1,receive,373270910,602395
373873751,20,4,receive,373261219,612532
373874237,590,2,receive,373272425,601812
373874735,172,2,receive,373273789,600946
374106845,128,3,receive,373275202,831643
374107331,456,1,receive,373276083,831248
374107926,196,2,receive,373276902,831024
374108380,188,1,receive,373276852,831528
374108861,110,2,receive,373277086,831775
374109321,184,3,receive,373277380,831941
374109774,162,1,receive,373277349,832425
374110247,20,5,receive,373276963,833284
374110692,12,4,receive,373278229,832463
374111160,164,1,receive,373272121,839039
374318551,82,2,receive,373266117,1052434
374318970,394,1,receive,373278752,1040218
374319569,34,5,receive,373244407,1075162
374319975,40,5,receive,373278855,1041120
374320377,230,1,receive,373279031,1041346
374320771,492,1,receive,373279049,1041722
374321200,570,1,receive,373279141,1042059
374321605,36,1,receive,373280391,1041214
374322108,152,2,receive,373281154,1040954
374322552,88,2,receive,373263989,1058563
374323026,52,3,receive,373248117,1074909
374557477,154,1,receive,373286200,1271277
374558002,186,3,receive,373272645,1285357
374558430,196,3,receive,373287096,1271334
374558859,114,3,receive,373287285,1271574
374559274,96,2,receive,373287418,1271856
374559663,76,3,receive,373251724,1307939
374560093,590,3,receive,373289408,1270685
374560536,778,1,receive,373289648,1270888
374560939,86,1,receive,373290793,1270146
374561329,98,1,receive,373291041,1270288
374561724,868,1,receive,373291114,1270610
374562191,590,4,receive,373292667,1269524
374829709,104,2,receive,373292892,1536817
374830134,90,2,receive,373293038,1537096
374830719,778,2,receive,373293094,1537625
374831147,432,1,receive,373294811,1536336
374831688,68,1,receive,373294917,1536771
374832145,346,1,receive,373295462,1536683
374832604,320,1,receive,373296620,1535984
374833059,108,2,receive,373288603,1544456
374833555,84,1,receive,373282609,1550946
374834001,302,1,receive,373297189,1536812
375056204,84,2,receive,373297268,1758936
375058155,612,1,receive,373297315,1760840
375058731,150,2,receive,373297382,1761349
375059216,974,1,receive,373292613,1766603
375059670,674,1,receive,373297959,1761711
375060153,106,2,receive,373298141,1762012
375282144,778,3,receive,373298369,1983775
375282611,104,3,receive,373300144,1982467
375283179,98,2,receive,373301015,1982164
375283639,152,3,receive,373301213,1982426
375284117,384,1,receive,373301901,1982216
375284582,86,2,receive,373303095,1981487
375285049,448,1,receive,373303372,1981677
375285538,486,1,receive,373304542,1980996
375286017,42,3,receive,373242320,2043697
375286475,426,1,receive,373306585,1979890
375550497,160,2,receive,373306687,2243810
375550977,634,1,receive,373308105,2242872
375551686,408,1,receive,373308867,2242819
375552174,870,1,receive,373309486,2242688
375552655,210,1,receive,373310039,2242616
375553116,26,4,receive,373245006,2308110
375553606,114,4,receive,373311673,2241933
375554078,64,3,receive,373282318,2271760
375554564,30,1,receive,373312619,2241945
375759380,196,4,receive,373313394,2445986
375759947,408,2,receive,373314436,2445511
375760540,974,2,receive,373314787,2445753
375761015,140,2,receive,373316070,2444945
375761516,104,4,receive,373316474,2445042
375762036,184,4,receive,373316662,2445374
375762652,166,1,receive,373316885,2445767
375763121,128,4,receive,373317077,2446044
375763624,790,1,receive,373318464,2445160
375983594,798,1,receive,373318566,2665028
375984095,50,1,receive,373318434,2665661
375984683,196,5,receive,373318774,2665909
375985175,54,1,receive,373318997,2666178
375985642,18,2,receive,373320016,2665626
375986161,202,3,receive,373294291,2691870
375986621,80,1,receive,373322157,2664464
375987101,86,3,receive,373322441,2664660
375987573,400,1,receive,373323456,2664117
375988055,122,1,receive,373296841,2691214
376255314,158,1,receive,373304081,2951233
376255811,230,2,receive,373326675,2929136
376256403,320,2,receive,373327062,2929341
376256871,98,3,receive,373323391,2933480
376257333,384,2,receive,373330017,2927316
376257918,252,1,receive,373331018,2926900
376258385,634,2,receive,373331441,2926944
376258850,632,1,receive,373332263,2926587
376259325,118,1,receive,373332253,2927072
376476657,6,4,receive,373278304,3198353
376477135,90,3,receive,373332855,3144280
376477712,818,1,receive,373332891,3144821
376478245,90,4,receive,373333221,3145024
376478753,400,2,receive,373333307,3145446
376479220,150,3,receive,373334297,3144923
376479687,44,5,receive,373273715,3205972
376480172,154,2,receive,373334689,3145483
376480694,486,2,receive,373334774,3145920
376696405,758,1,receive,373334743,3361662
376696889,182,3,receive,373296292,3400597
376697484,206,2,receive,373335639,3361845
376697968,972,1,receive,373336349,3361619
376698440,798,2,receive,373336605,3361835
376698919,728,1,receive,373337175,3361744
376699400,152,4,receive,373321810,3377590
376699876,58,4,receive,373280331,3419545
376700378,670,1,receive,373337448,3362930
376700848,766,1,receive,373337608,3363240
376960734,132,1,receive,373337427,3623307
376961190,84,3,receive,373324172,3637018
376961751,312,1,receive,373339142,3622609
376962223,312,2,receive,373339616,3622607
376962680,100,1,receive,373257727,3704953
376963158,96,3,receive,373340772,3622386
376963817,274,1,receive,373342284,3621533
376964293,204,1,receive,373342449,3621844
376964735,188,2,receive,373340656,3624079
376965174,426,2,receive,373343822,3621352
377199305,408,3,receive,373344177,3855128
377199878,338,1,receive,373344313,3855565
377200330,18,3,receive,373343300,3857030
377200783,12,5,receive,373315677,3885106
377201259,138,1,receive,373345262,3855997
377201708,626,1,receive,373345494,3856214
377202154,110,3,receive,373345744,3856410
377202610,590,5,receive,373345797,3856813
377203069,782,1,receive,373346124,3856945
377434181,160,3,receive,373346421,4087760
377434762,290,1,receive,373311159,4123603
377435319,964,1,receive,373346825,4088494
377435769,96,4,receive,373346856,4088913
377436269,432,2,receive,373347684,4088585
377436718,670,2,receive,373349026,4087692
377437207,632,2,receive,373350024,4087183
377437654,106,3,receive,373351343,4086311
377438099,708,1,receive,373351772,4086327
377656761,158,2,receive,373351916,4304845
377657218,150,4,receive,373352784,4304434
377657801,284,1,receive,373353815,4303986
377658251,70,5,receive,373288342,4369909
377658696,868,2,receive,373354805,4303891
377659131,426,3,receive,373354781,4304350
377659599,730,1,receive,373355393,4304206
377660087,206,3,receive,373355353,4304734
377660539,1000,1,receive,373355649,4304890
377660988,382,1,receive,373356097,4304891
377906763,320,3,receive,373357048,4549715
377907240,80,2,receive,373357455,4549785
377907831,36,2,receive,373357977,4549854
377908277,56,3,receive,373241375,4666902
377908749,490,1,receive,373358269,4550480
377909195,400,3,receive,373358854,4550341
377909645,554,1,receive,373359320,4550325
377910116,598,1,receive,373359649,4550467
377910560,104,5,receive,373360476,4550084
377910994,212,1,receive,373360429,4550565
378173152,818,2,receive,373360893,4812259
378173611,128,5,receive,373361359,4812252
378174167,190,1,receive,373362713,4811454
378174614,764,1,receive,373362713,4811901
378175070,210,2,receive,373363083,4811987
378175564,230,3,receive,373364522,4811042
378176011,778,4,receive,373364429,4811582
378176456,592,1,receive,373364608,4811848
378176930,488,1,receive,373367149,4809781
378177379,426,4,receive,373367583,4809796
378397215,332,1,receive,373367726,5029489
378397802,354,1,receive,373368455,5029347
378398371,114,5,receive,373368894,5029477
378398893,582,1,receive,373368957,5029936
378399373,86,4,receive,373369044,5030329
378399850,640,1,receive,373369448,5030402
378400312,166,2,receive,373358761,5041551
378400778,300,1,receive,373370044,5030734
378401244,192,1,receive,373370182,5031062
378599925,712,1,receive,373370313,5229612
378600414,486,3,receive,373371338,5229076
378601143,130,3,receive,373309045,5292098
378601666,524,1,receive,373374149,5227517
378602152,130,4,receive,373373933,5228219
378602728,530,1,receive,373374600,5228128
378603242,436,1,receive,373374829,5228413
378604091,130,5,receive,373375029,5229062
378794364,90,5,receive,373376866,5417498
378794924,508,1,receive,373376887,5418037
378795373,130,6,receive,373376476,5418897
378795838,972,2,receive,373377276,5418562
378796321,426,5,receive,373377644,5418677
378796866,634,3,receive,373378345,5418521
378797304,918,1,receive,373378463,5418841
378797763,618,1,receive,373379066,5418697
378798215,166,3,receive,373380013,5418202
378969416,112,2,receive,373285041,5684375
378969976,196,6,receive,373381922,5588054
378970453,868,3,receive,373382063,5588390
378970913,8,5,receive,373278178,5692735
378971381,90,6,receive,373382316,5589065
378971838,400,4,receive,373382781,5589057
378972309,340,1,receive,373296934,5675375
378972764,486,4,receive,373383975,5588789
378973229,432,3,receive,373383008,5590221
379163743,126,2,receive,373305048,5858695
379164209,222,1,receive,373375932,5788277
379164761,316,1,receive,373386209,5778552
379165232,486,5,receive,373386787,5778445
379165697,730,2,receive,373387278,5778419
379166151,2,5,receive,373273391,5892760
379166620,154,3,receive,373388709,5777911
379167075,734,1,receive,373389539,5777536
379167534,444,1,receive,373334200,5833334
379342199,436,2,receive,373390018,5952181
379342676,638,1,receive,373371725,5970951
379343254,492,2,receive,373390020,5953234
379343721,366,1,receive,373390145,5953576
379344184,618,2,receive,373390437,5953747
379344662,62,4,receive,373250337,6094325
379345157,774,1,receive,373390624,5954533
379345604,756,1,receive,373390885,5954719
379346096,554,2,receive,373391272,5954824
379481551,196,7,receive,373391318,6090233
379482014,678,1,receive,373391717,6090297
379482571,964,2,receive,373391772,6090799
379483014,724,1,receive,373392160,6090854
379483516,64,4,receive,373354344,6129172
379483971,488,2,receive,373393759,6090212
379484535,798,3,receive,373393968,6090567
379485009,320,4,receive,373394395,6090614
379485476,222,2,receive,373395466,6090010
379636127,778,5,receive,373395541,6240586
379636607,778,6,receive,373395881,6240726
379637178,32,3,receive,373285087,6352091
379637631,206,4,receive,373396720,6240911
379638129,336,1,receive,373396941,6241188
379638608,2,6,receive,373393761,6244847
379639064,766,2,receive,373397603,6241461
379639554,352,1,receive,373355333,6284221
379640032,164,2,receive,373287511,6352521
379784786,434,1,receive,373398867,6385919
379785264,804,1,receive,373398932,6386332
379785963,456,2,receive,373399942,6386021
379786432,858,1,receive,373343766,6442666
379786901,612,2,receive,373391742,6395159
379787384,150,5,receive,373400589,6386795
379787860,560,1,receive,373401198,6386662
379788317,330,1,receive,373400981,6387336
379788775,204,2,receive,373401651,6387124
379789224,564,1,receive,373401672,6387552
379940192,222,3,receive,373402437,6537755
379940660,778,7,receive,373402673,6537987
379941249,230,4,receive,373403215,6538034
379941702,586,1,receive,373403229,6538473
379942153,670,3,receive,373403888,6538265
379942599,982,1,receive,373404064,6538535
379943040,592,2,receive,373404299,6538741
379943506,554,3,receive,373404704,6538802
379943949,994,1,receive,373404655,6539294
379944408,634,4,receive,373405133,6539275
380102266,634,5,receive,373405599,6696667
380102736,426,6,receive,373405950,6696786
380103294,964,3,receive,373407361,6695933
380103873,316,2,receive,373407547,6696326
380104319,844,1,receive,373407892,6696427
380104777,586,2,receive,373408806,6695971
380105222,566,1,receive,373360373,6744849
380105667,482,1,receive,373410119,6695548
380106128,370,1,receive,373410438,6695690
380251186,836,1,receive,373411253,6839933
380251652,836,2,receive,373411872,6839780
380252215,54,2,receive,373411868,6840347
380252676,150,6,receive,373412059,6840617
380253151,252,2,receive,373415349,6837802
380253624,312,3,receive,373415998,6837626
380254095,448,2,receive,373327134,6926961
380254683,238,1,receive,373416159,6838524
380255146,312,4,receive,373416340,6838806
380255615,396,1,receive,373416732,6838883
380377256,868,4,receive,373416750,6960506
380377731,640,2,receive,373417199,6960532
380378345,318,1,receive,373417412,6960933
380378804,530,2,receive,373420076,6958728
380379276,746,1,receive,373420030,6959246
380379716,192,2,receive,373420126,6959590
380380198,810,1,receive,373420516,6959682
380380688,502,1,receive,373422960,6957728
380381161,122,4,receive,373770030,6611131
380489229,982,13,receive,373772746,6716483
380489729,476,1,receive,373460047,7029682
380490296,832,2,receive,373772855,6717441
380490771,836,3,receive,373724735,6766036
380491266,416,4,receive,373773232,6718034
380491746,120,2,receive,373512170,6979576
380492203,508,8,receive,373773813,6718390
380492694,678,9,receive,373774061,6718633
380493202,740,4,receive,373774415,6718787
380601623,202,4,receive,373357060,7244563
380602253,66,8,receive,373625726,6976527
380602814,802,4,receive,373818365,6784449
380603513,866,1,receive,373709809,6893704
380604816,706,1,receive,373717534,6887282
380605316,394,4,receive,373872959,6732357
380605873,216,1,receive,373433119,7172754
380717498,372,5,receive,373734740,6982758
380718130,842,5,receive,373762586,6955544
380718664,202,6,receive,373827558,6891106
380719174,184,5,receive,373345697,7373477
380719621,240,6,receive,373924326,6795295
380721138,718,2,receive,373906904,6814234
380721590,524,10,receive,373712659,7008931
380722084,202,7,receive,373881299,6840785
380829568,638,2,receive,373410806,7418762
380830038,668,2,receive,373759700,7070338
380830601,862,5,receive,373927920,6902681
380831077,664,10,receive,373871823,6959254
380831536,524,11,receive,374114593,6716943
380831988,162,4,receive,373889090,6942898
380832473,144,4,receive,374133839,6698634
380832939,578,5,receive,374160840,6672099
380833394,408,13,receive,374123509,6709885
380833842,904,5,receive,374110659,6723183
380938579,452,6,receive,374127942,6810637
380939056,658,5,receive,374114896,6824160
380939665,670,15,receive,374126993,6812672
380940151,500,4,receive,374068390,6871761
380940642,940,11,receive,373975230,6965412
380941169,392,4,receive,374144952,6796217
380941644,224,6,receive,374343646,6597998
380942112,864,8,receive,374357131,6584981
380942569,672,5,receive,374337711,6604858
381048619,904,6,receive,374325511,6723108
381049116,228,10,receive,374242556,6806560
381049746,804,17,receive,374312659,6737087
381050261,948,4,receive,374318365,6731896
381050747,648,4,receive,374119654,6931093
381051232,190,5,receive,374346673,6704559
381051729,190,6,receive,374561578,6490151
381052230,226,7,receive,374348624,6703606
381052715,48,9,receive,374376703,6676012
381164623,954,5,receive,374327671,6836952
381165177,498,14,receive,374674546,6490631
381165847,284,9,receive,374620886,6544961
381166656,714,9,receive,374603017,6563639
381167175,362,11,receive,374624035,6543140
381167753,118,6,receive,374628807,6538946
381168246,236,6,receive,374641485,6526761
381168764,288,8,receive,374632670,6536094
381269100,230,14,receive,374425409,6843691
381270586,54,13,receive,374577575,6693011
