receive_timestamp,source_vehicle,message_id,event_type,send_timestamp,latency_us
262795008143,580,2,receive,262794955918,52225
262795008619,888,2,receive,262794981489,27130
262795009060,956,1,receive,262794984049,25011
262795009491,508,2,receive,262794961472,48019
262795009913,262,2,receive,262794986507,23406
262795010353,962,1,receive,262794987230,23123
262795010779,220,1,receive,262794979264,31515
262795011214,838,2,receive,262794990251,20963
262795011646,930,1,receive,262794990426,21220
262795138100,700,2,receive,262794990760,147340
262795138536,418,1,receive,262794895366,243170
262795138954,12,2,receive,262794920545,218409
262795139407,958,1,receive,262794999239,140168
262795139851,964,1,receive,262795001085,138766
262795140299,954,1,receive,262795002131,138168
262795140741,950,1,receive,262795006730,134011
262795218121,944,1,receive,262795008940,209181
262795218604,952,1,receive,262795010977,207627
262795219080,358,2,receive,262795011078,208002
262795220182,942,1,receive,262795012579,207603
262795235030,20,2,receive,262794917166,317864
262795249034,946,1,receive,262795013041,235993
262795300543,404,1,receive,262795004819,295724
262795301017,960,1,receive,262795017037,283980
262795301480,162,2,receive,262795004120,297360
262795301936,586,2,receive,262795027329,274607
262795302409,98,2,receive,262794964568,337841
262795302871,940,1,receive,262795036121,266750
262795303355,210,2,receive,262794982172,321183
262795303814,78,2,receive,262795022226,281588
262795416306,830,2,receive,262794976027,440279
262795416758,422,2,receive,262794986217,430541
262795417222,132,2,receive,262794906265,510957
262795417973,160,2,receive,262795016847,401126
262795418417,918,2,receive,262795049131,369286
262795418859,794,2,receive,262795023196,395663
262795419324,112,2,receive,262795056133,363191
262795419774,976,1,receive,262795073341,346433
262795530283,932,1,receive,262795063596,466687
262795530717,364,2,receive,262795067571,463146
262795531197,982,1,receive,262795079056,452141
262795531659,984,1,receive,262795081846,449813
262795532122,276,2,receive,262795039009,493113
262795532571,520,2,receive,262795005006,527565
262795533029,532,2,receive,262794950393,582636
262795533489,858,2,receive,262795060530,472959
262795533942,50,2,receive,262795070087,463855
262795627491,534,2,receive,262795001570,625921
262795627939,366,2,receive,262795001827,626112
262795628412,902,2,receive,262795074010,554402
262795628872,768,2,receive,262795088944,539928
262795629355,142,2,receive,262795092212,537143
262795629818,834,2,receive,262795077081,552737
262795630296,972,1,receive,262795096706,533590
262795630760,26,2,receive,262795026885,603875
262795732718,88,2,receive,262795033006,699712
262795733185,970,1,receive,262795098258,634927
262795733639,568,2,receive,262795021119,712520
262795734105,380,2,receive,262795017297,716808
262795734557,988,1,receive,262795103063,631494
262795752386,488,2,receive,262794998425,753961
262795752826,536,2,receive,262795056071,696755
262795809787,968,1,receive,262795108099,701688
262795810253,974,1,receive,262795108579,701674
262795810692,986,1,receive,262795109127,701565
262795832196,980,1,receive,262795113334,718862
262795832651,178,2,receive,262795086010,746641
262795852488,996,1,receive,262795116543,735945
262795930557,886,2,receive,262795051291,879266
262795931026,82,2,receive,262795037400,893626
262795931493,966,1,receive,262795122559,808934
262795931945,382,1,receive,262795125558,806387
262795932614,494,2,receive,262795094268,838346
262795933051,952,2,receive,262795130580,802471
262795933483,978,1,receive,262795121129,812354
262795933910,994,1,receive,262795136986,796924
262796027039,52,2,receive,262795086293,940746
262796027513,992,1,receive,262795141061,886452
262796027991,556,2,receive,262795067005,960986
262796028469,998,1,receive,262795151122,877347
262796028930,990,1,receive,262795143046,885884
262796029403,134,2,receive,262795112506,916897
262796029862,384,2,receive,262795049007,980855
262796130133,120,2,receive,262795115113,1015020
262796130568,42,2,receive,262794953452,1177116
262796131009,594,2,receive,262795128109,1002900
262796131473,372,2,receive,262795117342,1014131
262796131925,936,1,receive,262795163022,968903
262796132390,166,2,receive,262795160380,972010
262796132838,274,2,receive,262795127683,1005155
262796228033,164,2,receive,262795098347,1129686
262796228499,354,3,receive,262795164104,1064395
262796228959,480,2,receive,262795083207,1145752
262796229435,64,2,receive,262795108346,1121089
262796229900,702,2,receive,262795104028,1125872
262796230388,790,2,receive,262795139013,1091375
262796230847,890,2,receive,262795181759,1049088
262796338653,848,2,receive,262795104007,1234646
262796339127,736,3,receive,262795155175,1183952
262796339578,772,2,receive,262795183574,1156004
262796340039,234,2,receive,262794962090,1377949
262796358252,150,2,receive,262795192006,1166246
262796358699,810,2,receive,262795172580,1186119
262796359152,428,2,receive,262795178010,1181142
262796359591,842,2,receive,262795157008,1202583
262796464065,538,2,receive,262795169780,1294285
262796464538,870,2,receive,262795191036,1273502
262796465016,122,2,receive,262795151020,1313996
262796465484,866,2,receive,262795217068,1248416
262796474948,244,2,receive,262795151315,1323633
262796475405,144,1,receive,262795217066,1258339
262796475844,46,2,receive,262795174774,1301070
262796560365,60,2,receive,262795028316,1532049
262796560832,938,2,receive,262795200017,1360815
262796561303,880,2,receive,262795130518,1430785
262796564100,86,2,receive,262795156011,1408089
262796564569,722,2,receive,262795202016,1362553
262796565046,184,2,receive,262795188876,1376170
262796665628,1000,1,receive,262795235958,1429670
262796666101,778,2,receive,262795225615,1440486
262796666568,358,3,receive,262795158156,1508412
262796667039,14,2,receive,262795227167,1439872
262796667504,854,2,receive,262795025945,1641559
262796667959,62,2,receive,262795198065,1469894
262796706260,874,2,receive,262795207780,1498480
262796759339,128,2,receive,262795211230,1548109
262796759797,348,2,receive,262795126019,1633778
262796760269,236,2,receive,262795176062,1584207
262796760727,698,2,receive,262795182874,1577853
262796761190,976,2,receive,262795242365,1518825
262796761639,542,2,receive,262795202559,1559080
262796762099,34,2,receive,262795224006,1538093
262796762552,896,2,receive,262795262010,1500542
262796867390,198,2,receive,262795175713,1691677
262796867843,6,2,receive,262795222621,1645222
262796868411,754,2,receive,262795279349,1589062
262796868860,720,2,receive,262795182834,1686026
262796869322,186,2,receive,262795255131,1614191
262796869787,682,2,receive,262795174077,1695710
262796954656,76,2,receive,262795242141,1712515
262796955136,954,2,receive,262795186367,1768769
262796955599,80,2,receive,262795265363,1690236
262796956069,168,2,receive,262795223810,1732259
262796956532,586,3,receive,262795298077,1658455
262796956997,840,2,receive,262795288011,1668986
262796957468,262,3,receive,262795303009,1654459
262796957931,958,2,receive,262795271506,1686425
262797086633,618,2,receive,262795192141,1894492
262797087092,590,2,receive,262795291956,1795136
262797091029,508,3,receive,262795299362,1791667
262797111037,670,2,receive,262795315688,1795349
262797111516,940,2,receive,262795298578,1812938
262797111979,580,3,receive,262795239149,1872830
262797112452,442,3,receive,262795317101,1795351
262797112911,222,2,receive,262795262006,1850905
262797242410,116,2,receive,262795283474,1958936
262797242863,704,2,receive,262795281568,1961295
262797243331,202,2,receive,262795211565,2031766
262797243787,230,2,receive,262795316860,1926927
262797272318,88,3,receive,262795262006,2010312
262797272777,54,2,receive,262795312072,1960705
262797273245,24,2,receive,262795265106,2008139
262797273707,356,2,receive,262795334689,1939018
262797372196,994,2,receive,262795279482,2092714
262797372657,972,2,receive,262795335015,2037642
262797373128,932,2,receive,262795362451,2010677
262797373583,716,2,receive,262795286512,2087071
262797374057,978,2,receive,262795291139,2082918
262797374518,480,3,receive,262795365448,2009070
262797374974,876,2,receive,262795299282,2075692
262797446796,224,1,receive,262795360803,2085993
262797447260,674,2,receive,262795319006,2128254
262797447723,806,2,receive,262795326007,2121716
262797448202,532,3,receive,262795382857,2065345
262797448676,910,2,receive,262795350269,2098407
262797449165,162,3,receive,262795324648,2124517
262797449638,526,2,receive,262795297210,2152428
262797554496,50,3,receive,262795387475,2167021
262797554965,26,3,receive,262795375402,2179563
262797555446,352,2,receive,262795333283,2222163
262797555904,956,2,receive,262795347798,2208106
262797556379,112,3,receive,262795227563,2328816
262797556845,794,3,receive,262795349072,2207773
262797557316,610,2,receive,262795387010,2170306
262797646747,354,4,receive,262795405501,2241246
262797647212,110,3,receive,262795414267,2232945
262797647676,632,2,receive,262795398098,2249578
262797648169,344,2,receive,262795348014,2300155
262797648631,862,2,receive,262795319006,2329625
262797649125,638,2,receive,262795420640,2228485
262797649594,234,3,receive,262795361017,2288577
262797781377,422,3,receive,262795381926,2399451
262797781837,118,2,receive,262795369010,2412827
262797782312,134,3,receive,262795436763,2345549
262797782779,538,3,receive,262795418007,2364772
262797783248,640,1,receive,262795446205,2337043
262797783706,2,2,receive,262795380007,2403699
262797784189,432,3,receive,262795371008,2413181
262797784654,244,3,receive,262795375374,2409280
262797905307,852,2,receive,262795397064,2508243
262797905764,92,2,receive,262795439214,2466550
262797906253,986,2,receive,262795352838,2553415
262797906702,612,2,receive,262795466222,2440480
262797914819,126,2,receive,262795386102,2528717
262797915305,908,2,receive,262795423009,2492296
262797915780,814,2,receive,262795399084,2516696
262798019297,706,2,receive,262795460020,2559277
262798019775,760,2,receive,262795479730,2540045
262798020256,278,2,receive,262795462010,2558246
262798020724,628,3,receive,262795470139,2550585
262798036196,556,3,receive,262795491005,2545191
262798036659,384,3,receive,262795398006,2638653
262798122179,826,2,receive,262795477450,2644729
262798122634,106,2,receive,262795409827,2712807
262798123094,218,2,receive,262795411014,2712080
262798123543,10,2,receive,262795422099,2701444
262798123997,950,2,receive,262795386486,2737511
262798124451,604,1,receive,262795499076,2625375
262798124900,388,2,receive,262795468008,2656892
262798125365,962,2,receive,262795437072,2688293
262798125814,724,2,receive,262795499152,2626662
262798241313,758,3,receive,262795409919,2831394
262798241771,964,2,receive,262795447010,2794761
262798242243,42,3,receive,262795494475,2747768
262798242696,34,3,receive,262795412512,2830184
262798243157,6,3,receive,262795493676,2749481
262798243613,586,4,receive,262795480620,2762993
262798244070,184,3,receive,262795507964,2736106
262798244531,392,2,receive,262795450629,2793902
262798244978,138,2,receive,262795500064,2744914
262798375293,930,2,receive,262795446115,2929178
262798375770,824,2,receive,262795491367,2884403
262798376258,804,2,receive,262795484006,2892252
262798376735,816,2,receive,262795419597,2957138
262798377229,420,2,receive,262795508505,2868724
262798377702,708,2,receive,262795531189,2846513
262798486205,382,2,receive,262795487989,2998216
262798486636,912,2,receive,262795505242,2981394
262798487094,206,2,receive,262795518078,2969016
262798487547,76,3,receive,262795473568,3013979
262798487997,838,3,receive,262795469159,3018838
262798511252,108,2,receive,262795532031,2979221
262798511697,166,3,receive,262795479005,3032692
262798589210,952,3,receive,262795453290,3135920
262798589672,896,3,receive,262795494009,3095663
262798590147,916,2,receive,262795457417,3132730
262798590606,224,2,receive,262795489819,3100787
262798591077,846,2,receive,262795479006,3112071
262798591541,494,3,receive,262795505525,3086016
262798591990,578,2,receive,262795561339,3030651
262798592456,450,2,receive,262795572557,3019899
262798592913,348,3,receive,262795493735,3099178
262798728464,864,2,receive,262795516693,3211771
262798728917,40,2,receive,262795483259,3245658
262798729405,86,3,receive,262795557225,3172180
262798729871,476,1,receive,262795572060,3157811
262798730346,738,2,receive,262795521983,3208363
262798730808,142,3,receive,262795486529,3244279
262798731285,788,2,receive,262795559530,3171755
262798731751,466,2,receive,262795548393,3183358
262798854110,850,2,receive,262795502006,3352104
262798854565,958,3,receive,262795573518,3281047
262798855029,372,3,receive,262795553842,3301187
262798855489,678,2,receive,262795537007,3318482
262798860413,208,2,receive,262795566356,3294057
262798874822,352,3,receive,262795559887,3314935
262798875292,22,2,receive,262795555186,3320106
262798956357,744,2,receive,262795541610,3414747
262798956831,928,2,receive,262795576207,3380624
262798957308,12,3,receive,262795520504,3436804
262798957776,968,2,receive,262795525987,3431789
262798958257,358,4,receive,262795483103,3475154
262798958734,934,2,receive,262795578622,3380112
262798959214,132,3,receive,262795587556,3371658
262798959682,588,2,receive,262795586010,3373672
262799087250,398,2,receive,262795615009,3472241
262799087708,734,2,receive,262795601499,3486209
262799088175,116,3,receive,262795488851,3599324
262799088631,596,2,receive,262795570092,3518539
262799089087,890,3,receive,262795572281,3516806
262799089543,290,1,receive,262795626425,3463118
262799089995,730,2,receive,262795545268,3544727
262799090449,820,3,receive,262795632840,3457609
262799184552,80,3,receive,262795588010,3596542
262799185027,888,3,receive,262795578104,3606923
262799185496,186,3,receive,262795601564,3583932
262799185957,482,2,receive,262795523779,3662178
262799186429,38,2,receive,262795524005,3662424
262799186885,472,2,receive,262795638005,3548880
262799187354,682,3,receive,262795595246,3592108
262799187818,844,2,receive,262795642562,3545256
262799306543,630,2,receive,262795569010,3737533
262799307021,906,2,receive,262795638137,3668884
262799307490,134,4,receive,262795608010,3699480
262799307945,226,2,receive,262795638811,3669134
262799308420,582,2,receive,262795620067,3688353
262799351361,818,2,receive,262795633105,3718256
262799351822,894,2,receive,262795629083,3722739
262799423310,168,3,receive,262795657536,3765774
262799423759,782,2,receive,262795595033,3828726
262799424229,18,2,receive,262795554865,3869364
262799424678,736,4,receive,262795650081,3774597
262799425136,938,3,receive,262795560006,3865130
262799425583,802,2,receive,262795544016,3881567
262799426035,812,2,receive,262795552158,3873877
262799426491,914,2,receive,262795515185,3911306
262799562324,74,3,receive,262795547996,4014328
262799562772,364,3,receive,262795585828,3976944
262799563244,140,2,receive,262795631081,3932163
262799563695,98,3,receive,262795668205,3895490
262799564158,590,3,receive,262795642006,3922152
262799564615,532,4,receive,262795673062,3891553
262799565074,150,3,receive,262795618193,3946881
262799679759,732,2,receive,262795691449,3988310
262799680206,824,3,receive,262795692714,3987492
262799680646,96,2,receive,262795614422,4066224
262799681120,28,2,receive,262795611132,4069988
262799681579,726,2,receive,262795581494,4100085
262799682044,380,3,receive,262795602080,4079964
262799682510,366,3,receive,262795617548,4064962
262799682964,72,2,receive,262795661006,4021958
262799804450,984,2,receive,262795703009,4101441
262799804887,670,3,receive,262795667006,4137881
262799805337,810,3,receive,262795705012,4100325
262799805802,842,3,receive,262795695142,4110660
262799821598,638,3,receive,262795673010,4148588
262799822064,464,2,receive,262795701111,4120953
262799822533,960,2,receive,262795749079,4073454
262799822989,148,2,receive,262795696007,4126982
262799920898,34,4,receive,262795690020,4230878
262799921371,880,3,receive,262795736091,4185280
262799921826,854,3,receive,262795736007,4185819
262799922287,712,2,receive,262795675323,4246964
262799922737,926,2,receive,262795826008,4096729
262799951708,780,2,receive,262795688006,4263702
262800016180,152,2,receive,262795823006,4193174
262800016636,732,3,receive,262795816006,4200630
262800017099,952,4,receive,262795852010,4165089
262800017567,822,2,receive,262795819024,4198543
262800018034,48,2,receive,262795648323,4369711
262800018501,536,3,receive,262795855006,4163495
262800050366,210,3,receive,262795871005,4179361
262800050830,110,4,receive,262795924567,4126263
262800121403,362,2,receive,262795842006,4279397
262800121836,390,1,receive,262795954037,4167799
262800122285,890,4,receive,262795932006,4190279
262800122720,778,3,receive,262795879389,4243331
262800123188,8,3,receive,262795941273,4181915
262800123647,124,3,receive,262796003069,4120578
262800124118,994,3,receive,262795982009,4142109
262800124573,1000,2,receive,262796026321,4098252
262800231879,804,3,receive,262795945672,4286207
262800232369,880,4,receive,262795993010,4239359
262800232845,534,3,receive,262795981200,4251645
262800233326,206,3,receive,262796116088,4117238
262800233793,58,3,receive,262796146617,4087176
262800234270,62,3,receive,262795971061,4263209
262800234738,830,3,receive,262796079181,4155557
262800337631,366,4,receive,262796008051,4329580
262800338097,688,3,receive,262796132214,4205883
262800338555,594,3,receive,262796115211,4223344
262800353024,218,4,receive,262796221993,4131031
262800353853,28,4,receive,262796240449,4113404
262800354327,274,3,receive,262796171673,4182654
262800354786,78,4,receive,262796193145,4161641
262800448287,56,3,receive,262796239311,4208976
262800448718,838,6,receive,262796246891,4201827
262800449181,778,4,receive,262796154362,4294819
262800449626,112,4,receive,262796349128,4100498
262800467093,526,3,receive,262796147265,4319828
262800476224,560,2,receive,262796294253,4181971
262800476660,720,3,receive,262796292005,4184655
262800549393,896,4,receive,262796154976,4394417
262800549842,38,3,receive,262796372006,4177836
262800550299,716,3,receive,262796190649,4359650
262800550740,500,3,receive,262796238760,4311980
262800551218,508,5,receive,262796466009,4085209
262800551684,610,3,receive,262796380853,4170831
262800552160,44,3,receive,262796419843,4132317
262800552625,794,4,receive,262796451119,4101506
262800660122,900,4,receive,262796384978,4275144
262800660599,864,3,receive,262796472166,4188433
262800661070,234,4,receive,262796378835,4282235
262800661531,868,3,receive,262796535962,4125569
262800661990,198,3,receive,262796259983,4402007
262800662453,352,4,receive,262796553648,4108805
262800662901,42,5,receive,262796555201,4107700
262800736771,526,4,receive,262796575197,4161574
262800737256,378,3,receive,262796559141,4178115
262800737719,22,3,receive,262796615805,4121914
262800738193,384,5,receive,262796424192,4314001
262800738654,860,3,receive,262796616224,4122430
262800739125,894,4,receive,262796604007,4135118
262800739585,608,3,receive,262796613488,4126097
262800847104,520,5,receive,262796640159,4206945
262800847561,716,4,receive,262796566203,4281358
262800848032,722,4,receive,262796722616,4125416
262800848506,856,3,receive,262796690013,4158493
262800848973,212,5,receive,262796731916,4117057
262800849451,380,4,receive,262796719458,4129993
262800849921,824,4,receive,262796731906,4118015
262800850407,224,6,receive,262796771850,4078557
262800850877,632,4,receive,262796706010,4144867
262800954523,114,4,receive,262796717206,4237317
262800954989,854,4,receive,262796791006,4163983
262800955473,702,4,receive,262796843477,4111996
262800955942,982,4,receive,262796869060,4086882
262800964307,706,4,receive,262796834857,4129450
262800964767,244,5,receive,262796866007,4098760
262800965239,556,5,receive,262796880030,4085209
262800965708,152,3,receive,262796888726,4076982
262801058591,466,6,receive,262796841005,4217586
262801059042,76,5,receive,262796903079,4155963
262801059496,62,4,receive,262796727220,4332276
262801059946,884,5,receive,262796927011,4132935
262801060408,348,6,receive,262796927738,4132670
262801060853,918,5,receive,262796965480,4095373
262801061319,68,3,receive,262796817292,4244027
262801061768,792,4,receive,262797090063,3971705
262801161236,102,4,receive,262797077154,4084082
262801161700,804,4,receive,262796943286,4218414
262801162182,536,5,receive,262797006855,4155327
262801162651,772,6,receive,262797062346,4100305
262801163160,700,5,receive,262797095884,4067276
262801163649,444,4,receive,262797120512,4043137
262801164147,132,5,receive,262797048006,4116141
262801164630,836,4,receive,262797259309,3905321
262801254816,688,4,receive,262797169010,4085806
262801255282,144,4,receive,262797191087,4064195
262801255737,902,5,receive,262797197010,4058727
262801256199,500,4,receive,262797199010,4057189
262801256657,464,4,receive,262797229744,4026913
262801282533,14,6,receive,262797244308,4038225
262801282966,54,4,receive,262797287009,3995957
262801283437,990,4,receive,262797343271,3940166
262801283888,124,7,receive,262797335011,3948877
262801360868,376,5,receive,262797370006,3990862
262801361369,212,6,receive,262797333227,4028142
262801361826,974,5,receive,262797386343,3975483
262801362304,104,4,receive,262797276519,4085785
262801375155,226,4,receive,262797386602,3988553
262801375619,658,1,receive,262797456086,3919533
262801430973,856,4,receive,262797426128,4004845
262801431427,778,6,receive,262797399521,4031906
262801431853,418,5,receive,262797360978,4070875
262801432283,978,5,receive,262797442011,3990272
262801447032,444,5,receive,262797470008,3977024
262801458980,206,6,receive,262797485065,3973915
262801459423,78,9,receive,262797569596,3889827
262801459854,738,5,receive,262797548006,3911848
262801533349,744,5,receive,262797524345,4009004
262801533779,288,4,receive,262797486353,4047426
262801534243,878,4,receive,262797579394,3954849
262801534693,502,1,receive,262797580897,3953796
262801535155,702,5,receive,262797764198,3770957
262801535603,434,5,receive,262797785302,3750301
262801536055,992,5,receive,262797714098,3821957
262801628208,820,6,receive,262797682010,3946198
262801628663,896,6,receive,262797743180,3885483
262801629132,848,6,receive,262797785539,3843593
262801629581,24,6,receive,262797782351,3847230
262801630043,120,9,receive,262797783665,3846378
262801630503,738,6,receive,262797734269,3896234
262801630959,432,6,receive,262797757151,3873808
262801727469,724,5,receive,262797774086,3953383
262801727905,662,1,receive,262797811139,3916766
262801728363,954,5,receive,262797751213,3977150
262801728812,942,4,receive,262797797706,3931106
262801729270,996,4,receive,262797804807,3924463
262801729718,76,8,receive,262797942008,3787710
262801730172,68,5,receive,262797845049,3885123
262801730624,160,5,receive,262797881887,3848737
262801825099,146,4,receive,262797800325,4024774
262801825546,142,6,receive,262797898026,3927520
262801825967,862,5,receive,262797861125,3964842
262801826464,84,5,receive,262797930028,3896436
262801826919,766,5,receive,262797936006,3890913
262801842199,358,9,receive,262797989006,3853193
262801853025,792,6,receive,262797966006,3887019
262801879841,900,7,receive,262797941131,3938710
262801880309,364,8,receive,262797976793,3903516
262801880757,212,8,receive,262797992072,3888685
262801881241,218,7,receive,262797883487,3997754
262801881684,898,5,receive,262798007299,3874385
262801895553,28,6,receive,262798002012,3893541
262801895994,56,6,receive,262798083011,3812983
262801896445,604,4,receive,262798128989,3767456
262801896884,102,6,receive,262798128012,3768872
262801978378,274,7,receive,262798045398,3932980
262801978834,952,9,receive,262798110523,3868311
262801979335,538,7,receive,262797940007,4039328
262801979783,842,7,receive,262798232200,3747583
262801980253,136,5,receive,262798140006,3840247
262801980701,382,5,receive,262798220107,3760594
262802039936,906,6,receive,262798135952,3903984
262802040410,428,7,receive,262798239776,3800634
262802040872,932,6,receive,262798174519,3866353
262802041337,608,5,receive,262798148010,3893327
262802041786,144,5,receive,262798204478,3837308
262802042251,950,8,receive,262798193010,3849241
262802042708,670,9,receive,262798378593,3664115
262802117567,934,7,receive,262798344965,3772602
262802118027,162,8,receive,262798353283,3764744
262802118492,960,6,receive,262798372073,3746419
262802118944,996,6,receive,262798360184,3758760
262802119410,872,7,receive,262798245812,3873598
262802119864,610,6,receive,262798489962,3629902
262802120325,852,8,receive,262798453389,3666936
262802120777,552,7,receive,262798481006,3639771
262802203272,768,8,receive,262798450398,3752874
262802203730,236,6,receive,262798456411,3747319
262802204194,356,8,receive,262798469360,3734834
262802204650,358,10,receive,262798520012,3684638
262802205110,904,7,receive,262798507010,3698100
262802226079,908,7,receive,262798491487,3734592
262802226510,152,5,receive,262798531466,3695044
262802226934,230,6,receive,262798596179,3630755
262802283472,668,2,receive,262798596700,3686772
262802283933,444,7,receive,262798536010,3747923
262802284400,372,10,receive,262798597150,3687250
262802284851,820,8,receive,262798597577,3687274
262802285321,480,7,receive,262798567081,3718240
262802285777,92,7,receive,262798749253,3536524
262802371248,38,7,receive,262798750334,3620914
262802371694,206,9,receive,262798692048,3679646
262802372145,10,6,receive,262798750372,3621773
262802372612,758,10,receive,262798626633,3745979
262802373059,434,6,receive,262798698495,3674564
262802373506,662,2,receive,262798763655,3609851
262802373958,276,6,receive,262798744873,3629085
262802374421,670,10,receive,262798867756,3506665
262802460592,560,5,receive,262798712008,3748584
262802461061,876,7,receive,262798599316,3861745
262802461690,536,7,receive,262798839557,3622133
262802462166,382,7,receive,262798644913,3817253
262802462625,150,8,receive,262798868672,3593953
262802463099,72,7,receive,262798863122,3599977
262802463561,464,6,receive,262798963776,3499785
262802555630,940,7,receive,262798893579,3662051
262802556125,834,7,receive,262798887909,3668216
262802556585,502,3,receive,262798881290,3675295
262802557052,76,11,receive,262798945914,3611138
262802557527,804,6,receive,262798971307,3586220
262802557999,980,6,receive,262798767083,3790916
262802558476,44,6,receive,262798810006,3748470
262802558952,186,9,receive,262799108863,3450089
262802651022,730,7,receive,262799047433,3603589
262802651454,824,7,receive,262799109836,3541618
262802651898,60,8,receive,262799093016,3558882
262802652360,472,7,receive,262799048356,3604004
262802660132,868,7,receive,262799105733,3554399
262802660598,822,8,receive,262799011361,3649237
262802695845,398,7,receive,262799090051,3605794
262802696299,50,10,receive,262798886870,3809429
262802696732,88,8,receive,262799095006,3601726
262802697172,582,8,receive,262799112490,3584682
262802715369,782,8,receive,262798989065,3726304
262802721264,708,10,receive,262799100775,3620489
262802721714,976,10,receive,262799148532,3573182
262802763404,922,8,receive,262799121072,3642332
262802763869,288,7,receive,262799142634,3621235
262802764337,848,8,receive,262799144107,3620230
262802764799,490,5,receive,262799235152,3529647
262802765259,810,9,receive,262799325089,3440170
262802765722,262,10,receive,262799294257,3471465
262802802305,126,8,receive,262799255541,3546764
262802836353,10,7,receive,262799359522,3476831
262802836776,886,8,receive,262799308752,3528024
262802837217,212,11,receive,262799448628,3388589
262802837643,184,10,receive,262799418184,3419459
262802838075,766,7,receive,262799459577,3378498
262802838523,722,10,receive,262799411249,3427274
262802838981,892,9,receive,262799476314,3362667
262802839436,48,8,receive,262799259039,3580397
262802839875,788,11,receive,262799481558,3358317
262802903610,532,9,receive,262799365486,3538124
262802904052,768,10,receive,262799486752,3417300
262802904494,124,10,receive,262799529083,3375411
262802904941,84,7,receive,262799517437,3387504
262802905401,24,9,receive,262799486795,3418606
262802905847,916,8,receive,262799505104,3400743
262802906306,726,9,receive,262799480007,3426299
262802977515,444,9,receive,262799547922,3429593
262802977958,718,6,receive,262799617082,3360876
262802978414,622,6,receive,262799634201,3344213
262802978859,54,7,receive,262799683631,3295228
262802979335,634,9,receive,262799620284,3359051
262802979785,704,9,receive,262799687007,3292778
262802980271,712,9,receive,262799711730,3268541
262802980719,276,8,receive,262799690098,3290621
262803042277,274,10,receive,262799644948,3397329
262803042724,414,3,receive,262799721286,3321438
262803043175,830,10,receive,262799766261,3276914
262803043610,926,9,receive,262799815719,3227891
262803044055,866,10,receive,262799750761,3293294
262803044498,722,11,receive,262799789278,3255220
262803063225,898,8,receive,262799802964,3260261
262803063690,730,8,receive,262799803674,3260016
262803105825,96,9,receive,262799757602,3348223
262803106268,466,11,receive,262799915749,3190519
262803106701,682,9,receive,262799924562,3182139
262803107142,172,7,receive,262799919623,3187519
262803107574,86,9,receive,262799853483,3254091
262803108008,40,7,receive,262799850124,3257884
262803108458,38,9,receive,262799947714,3160744
262803108904,448,1,receive,262800020157,3088747
262803158373,802,8,receive,262800027640,3130733
262803158829,114,8,receive,262800001013,3157816
262803159298,470,3,receive,262799992606,3166692
262803159759,752,8,receive,262800036065,3123694
262803160217,290,10,receive,262800043005,3117212
262803160661,944,8,receive,262799998467,3162194
262803218385,18,9,receive,262800031344,3187041
262803218831,588,9,receive,262800179274,3039557
262803219286,98,12,receive,262800226065,2993221
262803219728,946,10,receive,262800242547,2977181
262803220202,118,9,receive,262800236043,2984159
262803220648,362,9,receive,262800187005,3033643
262803221100,848,9,receive,262800217401,3003699
262803221542,606,8,receive,262800084067,3137475
262803221986,820,11,receive,262800014188,3207798
262803278459,580,8,receive,262800242450,3036009
262803278898,70,9,receive,262800133069,3145829
262803279360,442,10,receive,262800233136,3046224
262803279804,194,3,receive,262800175513,3104291
262803280259,896,9,receive,262800172476,3107783
262803280699,578,11,receive,262800238264,3042435
262803281151,836,7,receive,262800191283,3089868
262803281595,812,10,receive,262800313137,2968458
262803354060,104,9,receive,262800334318,3019742
262803354514,674,9,receive,262800337082,3017432
262803354953,388,11,receive,262800306801,3048152
262803355399,448,2,receive,262800334006,3021393
262803355836,158,4,receive,262800323007,3032829
262803356280,372,13,receive,262800317563,3038717
262803356711,840,12,receive,262800465006,2891705
262803357157,814,11,receive,262800403007,2954150
262803418404,288,10,receive,262800464791,2953613
262803418823,470,4,receive,262800438512,2980311
262803419258,868,9,receive,262800420924,2998334
262803419674,48,9,receive,262800440081,2979593
262803420100,930,11,receive,262800391751,3028349
262803420537,76,14,receive,262800554368,2866169
262803420973,500,9,receive,262800528221,2892752
262803421423,882,8,receive,262800526005,2895418
262803421863,674,10,receive,262800515006,2906857
262803502711,974,9,receive,262800454704,3048007
262803503174,94,9,receive,262800564777,2938397
262803503622,526,10,receive,262800556296,2947326
262803504071,182,1,receive,262800530558,2973513
262803504513,42,13,receive,262800585257,2919256
262803519289,934,10,receive,262800661645,2857644
262803519712,316,3,receive,262800577752,2941960
262803574214,72,10,receive,262800596216,2977998
262803574670,908,13,receive,262800684758,2889912
262803575142,226,9,receive,262800603575,2971567
262803575597,488,10,receive,262800636006,2939591
262803576059,352,11,receive,262800792695,2783364
262803576519,600,9,receive,262800827881,2748638
262803576996,364,13,receive,262800852647,2724349
262803577461,274,12,receive,262800852063,2725398
262803577913,188,1,receive,262800844597,2733316
262803651450,490,7,receive,262800830335,2821115
262803651892,502,7,receive,262800711010,2940882
262803652355,848,10,receive,262800792007,2860348
262803652802,740,10,receive,262800799431,2853371
262803653258,836,8,receive,262800784497,2868761
262803653704,622,9,receive,262800833631,2820073
262803654156,152,11,receive,262800851540,2802616
262803654603,40,8,receive,262800869113,2785490
262803724491,44,9,receive,262800798801,2925690
262803724926,986,11,receive,262800845397,2879529
262803725375,820,12,receive,262800797249,2928126
262803725816,86,10,receive,262800925081,2800735
262803726265,614,10,receive,262800957846,2768419
262803726704,444,11,receive,262800946080,2780624
262803727154,596,13,receive,262800987636,2739518
262803727599,296,1,receive,262800984385,2743214
262803787063,682,10,receive,262800897848,2889215
262803787520,476,10,receive,262800936398,2851122
262803787972,394,8,receive,262800937983,2849989
262803788436,100,11,receive,262800990552,2797884
262803788882,404,10,receive,262801033010,2755872
262803789340,502,8,receive,262801024220,2765120
262803789804,942,9,receive,262801017007,2772797
262803834722,358,14,receive,262801058853,2775869
262803835211,996,11,receive,262800967384,2867827
262803835655,822,10,receive,262801039016,2796639
262803836112,146,10,receive,262801079015,2757097
262803836566,362,12,receive,262801022751,2813815
262803837017,916,11,receive,262801157082,2679935
262803837473,296,2,receive,262801146513,2690960
262803837918,392,11,receive,262801165734,2672184
262803892250,788,13,receive,262801100972,2791278
262803892703,786,11,receive,262801103009,2789694
262803893168,300,1,receive,262801186338,2706830
262803893616,906,11,receive,262801127990,2765626
262803894083,638,10,receive,262801043329,2850754
262803894539,520,12,receive,262801234935,2659604
262803894986,554,2,receive,262801186006,2708980
262803948472,274,13,receive,262801262313,2686159
262803948923,930,13,receive,262801233455,2715468
262803949380,382,10,receive,262801273927,2675453
262803949819,962,12,receive,262801139590,2810229
262803950273,970,9,receive,262801279870,2670403
262803950722,922,11,receive,262801191775,2758947
262803999485,70,10,receive,262801149463,2850022
262803999906,816,12,receive,262801318878,2681028
262804000367,920,9,receive,262801274089,2726278
262804000812,976,13,receive,262801276010,2724802
262804001277,762,12,receive,262801342527,2658750
262804001719,102,10,receive,262801365705,2636014
262804002174,884,12,receive,262801340825,2661349
262804002617,276,10,receive,262801271009,2731608
262804056106,838,14,receive,262801367009,2689097
262804056597,708,14,receive,262801438137,2618460
262804057052,388,13,receive,262801421827,2635225
262804057500,44,10,receive,262801433461,2624039
262804057947,226,10,receive,262801431677,2626270
262804058400,244,12,receive,262801458715,2599685
262804058844,874,13,receive,262801432403,2626441
262804059309,902,13,receive,262801473571,2585738
262804059755,438,9,receive,262801412635,2647120
262804107327,786,12,receive,262801516146,2591181
262804107773,774,13,receive,262801504199,2603574
262804108225,144,9,receive,262801545894,2562331
262804108670,324,4,receive,262801459953,2648717
262804109127,674,12,receive,262801541098,2568029
262804109570,126,11,receive,262801621793,2487777
262804110022,88,13,receive,262801546005,2564017
262804110477,436,4,receive,262801610268,2500209
262804110921,380,11,receive,262801638090,2472831
262804162358,694,2,receive,262801627410,2534948
262804162782,386,2,receive,262801602733,2560049
262804163214,738,11,receive,262801572278,2590936
262804163634,194,8,receive,262801819265,2344369
262804164094,962,13,receive,262801807244,2356850
262804164537,558,12,receive,262801838599,2325938
262804164975,918,14,receive,262801783767,2381208
262804213057,950,14,receive,262801795011,2418046
262804213495,494,13,receive,262801797398,2416097
262804213946,308,2,receive,262801851823,2362123
262804218718,312,2,receive,262801852070,2366648
262804219159,432,12,receive,262801800883,2418276
262804219600,86,11,receive,262801773072,2446528
262804263621,722,15,receive,262801839178,2424443
262804264068,788,14,receive,262801683090,2580978
262804264509,622,10,receive,262801850615,2413894
262804264976,536,12,receive,262801832076,2432900
262804265425,500,13,receive,262801832035,2433390
262804265862,410,1,receive,262801868844,2397018
262804266328,694,3,receive,262801859077,2407251
262804317241,738,12,receive,262801893323,2423918
262804317695,192,2,receive,262801874507,2443188
262804318156,272,6,receive,262801886839,2431317
262804318629,538,13,receive,262801911141,2407488
262804319074,874,14,receive,262801911854,2407220
262804319538,442,13,receive,262801877743,2441795
262804319988,954,11,receive,262801794012,2525976
262804320444,146,11,receive,262801914759,2405685
262804320892,610,11,receive,262801919693,2401199
262804375343,726,13,receive,262801987619,2387724
262804375798,582,13,receive,262801977423,2398375
262804376253,952,14,receive,262801968318,2407935
262804376692,324,5,receive,262801920930,2455762
262804377146,190,3,receive,262801979005,2398141
262804377592,136,10,receive,262802022037,2355555
262804417087,402,10,receive,262802021009,2396078
262804417528,968,10,receive,262802029266,2388262
262804417955,600,11,receive,262802042781,2375174
262804426912,256,1,receive,262802037024,2389888
262804436031,144,10,receive,262802021669,2414362
262804436461,788,15,receive,262802125008,2311453
262804436889,444,13,receive,262802080341,2356548
262804437342,236,11,receive,262802084174,2353168
262804437778,174,15,receive,262802097765,2340013
262804482826,658,9,receive,262802103846,2378980
262804483300,244,13,receive,262802105010,2378290
262804483751,180,5,receive,262802096192,2387559
262804484215,262,13,receive,262802085428,2398787
262804484674,684,5,receive,262802161640,2323034
262804485164,60,12,receive,262802171007,2314157
262804485614,772,15,receive,262802204338,2281276
262804537388,308,3,receive,262802145039,2392349
262804537857,154,8,receive,262802155010,2382847
262804538328,806,11,receive,262802209005,2329323
262804538780,998,12,receive,262802215857,2322923
262804574021,390,12,receive,262802245005,2329016
262804578414,930,14,receive,262802217005,2361409
262804578857,744,13,receive,262802272663,2306194
262804613999,444,14,receive,262802286636,2327363
262804614562,578,14,receive,262802249070,2365492
262804615017,700,13,receive,262802281509,2333508
262804615470,276,11,receive,262802268010,2347460
262804615913,214,5,receive,262802301007,2314906
262804616365,360,1,receive,262802362939,2253426
262804616810,872,12,receive,262802315006,2301804
262804670439,622,11,receive,262802353009,2317430
262804670899,392,13,receive,262802319773,2351126
262804671368,320,6,receive,262802382009,2289359
262804671825,86,12,receive,262802390804,2281021
262804672311,662,6,receive,262802396010,2276301
262804672778,480,13,receive,262802413023,2259755
262804673256,324,6,receive,262802463814,2209442
262804721333,892,14,receive,262802441012,2280321
262804721764,582,14,receive,262802555996,2165768
262804722214,392,14,receive,262802558808,2163406
262804722645,248,8,receive,262802480484,2242161
262804723082,902,15,receive,262802480086,2242996
262804723514,136,11,receive,262802508712,2214802
262804723961,708,16,receive,262802542925,2181036
262804724425,372,17,receive,262802549306,2175119
262804724874,32,12,receive,262802443376,2281498
262804779262,258,8,receive,262802567006,2212256
262804779752,700,14,receive,262802532312,2247440
262804780204,554,5,receive,262802525377,2254827
262804780644,464,10,receive,262802492006,2288638
262804781100,268,5,receive,262802697757,2083343
262804781549,950,16,receive,262802697507,2084042
262804781994,654,12,receive,262802660348,2121646
262804827760,398,13,receive,262802629241,2198519
262804828252,722,18,receive,262802628815,2199437
262804828702,80,15,receive,262802703040,2125662
262804829170,284,1,receive,262802691522,2137648
262804829618,102,12,receive,262802622841,2206777
262804843534,868,13,receive,262802710483,2133051
262804843979,906,13,receive,262802701034,2142945
262804870089,312,4,receive,262802694127,2175962
262804870581,410,3,receive,262802721006,2149575
262804871035,614,14,receive,262802703018,2168017
262804871494,328,5,receive,262802768508,2102986
262804871937,694,4,receive,262802741939,2129998
262804872389,172,12,receive,262802740351,2132038
262804872841,256,2,receive,262802713009,2159832
262804915316,100,14,receive,262802737009,2178307
262804915767,836,12,receive,262802776069,2139698
262804916222,258,9,receive,262802720202,2196020
262804916660,812,14,receive,262802835562,2081098
262804917116,968,12,receive,262802786885,2130231
262804925161,934,14,receive,262802760774,2164387
262804925602,682,14,receive,262802819881,2105721
262804955515,594,15,receive,262802833027,2122488
262804955947,70,12,receive,262802861009,2094938
262804956412,826,15,receive,262802867100,2089312
262804956856,612,13,receive,262802809006,2147850
262804957308,2,14,receive,262802817006,2140302
262804957753,262,14,receive,262802970895,1986858
262804958205,298,1,receive,262802964745,1993460
262804958643,502,13,receive,262802959142,1999501
262804995075,328,6,receive,262802987408,2007667
262804995546,754,13,receive,262803004004,1991542
262804996012,8,15,receive,262802946952,2049060
262804996482,404,13,receive,262802959489,2036993
262804996945,868,14,receive,262802991272,2005673
262804997409,772,16,receive,262802902632,2094777
262804997867,58,16,receive,262802945006,2052861
