receive_timestamp,source_vehicle,message_id,event_type,send_timestamp,latency_us
262794851665,586,1,receive,262794773034,78631
262794852301,680,1,receive,262794800964,51337
262794852889,556,1,receive,262794801210,51679
262794878381,80,1,receive,262794753077,125304
262794878999,810,1,receive,262794800687,78312
262794879612,682,1,receive,262794803273,76339
262794969520,848,1,receive,262794804357,165163
262794970169,688,1,receive,262794805146,165023
262794970807,670,1,receive,262794805425,165382
262794971445,706,1,receive,262794805754,165691
262794972092,532,1,receive,262794804039,168053
262794972732,866,1,receive,262794807290,165442
262795091642,846,1,receive,262794808433,283209
262795092321,700,1,receive,262794808661,283660
262795092986,666,1,receive,262794808832,284154
262795093646,726,1,receive,262794809152,284494
262795165580,886,1,receive,262794809654,355926
262795166242,280,1,receive,262794804038,362204
262795166903,534,1,receive,262794810019,356884
262795195269,742,1,receive,262794810046,385223
262795195939,734,1,receive,262794805975,389964
262795196629,738,1,receive,262794804564,392065
262795306238,578,1,receive,262794813571,492667
262795306903,614,1,receive,262794818064,488839
262795307593,766,1,receive,262794818592,489001
262795308286,814,1,receive,262794819547,488739
262795308973,760,1,receive,262794820818,488155
262795393975,620,1,receive,262794817830,576145
262795394668,864,1,receive,262794816273,578395
262795395360,612,1,receive,262794824582,570778
262795439154,768,1,receive,262794826059,613095
262795439844,472,1,receive,262794824203,615641
262795506328,890,1,receive,262794828041,678287
262795507012,902,1,receive,262794828444,678568
262795507704,878,1,receive,262794829373,678331
262795508403,558,1,receive,262794826751,681652
262795611434,882,1,receive,262794827769,783665
262795612136,730,1,receive,262794831114,781022
262795612834,780,1,receive,262794831798,781036
262795613528,32,1,receive,262794664030,949498
262795662528,174,1,receive,262794707028,955500
262795729415,538,1,receive,262794831395,898020
262795730109,774,1,receive,262794834551,895558
262795730803,782,1,receive,262794831156,899647
262795731495,230,1,receive,262794836017,895478
262795765751,568,1,receive,262794828903,936848
262795790874,276,1,receive,262794718788,1072086
262795791563,184,1,receive,262794837518,954045
262795792255,888,1,receive,262794838015,954240
262795792939,708,1,receive,262794823509,969430
262795889151,704,1,receive,262794836511,1052640
262795889837,536,1,receive,262794827439,1062398
262795890505,884,1,receive,262794818675,1071830
262795891171,880,1,receive,262794828803,1062368
262795891830,856,1,receive,262794841630,1050200
262795892495,674,1,receive,262794842731,1049764
262796021333,678,1,receive,262794849031,1172302
262796021985,868,1,receive,262794833809,1188176
262796022884,698,1,receive,262794848604,1174280
262796023564,806,1,receive,262794853081,1170483
262796039249,778,1,receive,262794855512,1183737
262796039899,720,1,receive,262794843242,1196657
262796125837,844,1,receive,262794842017,1283820
262796126587,900,1,receive,262794839300,1287287
262796127263,464,1,receive,262794827781,1299482
262796127931,804,1,receive,262794860983,1266948
262796230460,444,1,receive,262794861645,1368815
262796231181,790,1,receive,262794850137,1381044
262796231853,896,1,receive,262794858653,1373200
262796232533,870,1,receive,262794831029,1401504
262796233204,912,1,receive,262794858038,1375166
262796233882,116,1,receive,262794852130,1381752
262796342619,716,1,receive,262794853883,1488736
262796343666,876,1,receive,262794852260,1491406
262796351117,732,1,receive,262794852037,1499080
262796368420,854,1,receive,262794864460,1503960
262796433340,914,1,receive,262794874858,1558482
262796433990,828,1,receive,262794871988,1562002
262796435067,910,1,receive,262794873486,1561581
262796435741,892,1,receive,262794863422,1572319
262796436414,600,1,receive,262794874615,1561799
262796542122,124,2,receive,262794780600,1761522
262796542790,924,1,receive,262794879157,1663633
262796543468,918,1,receive,262794884191,1659277
262796552137,858,1,receive,262794875062,1677075
262796552813,628,2,receive,262794887482,1665331
262796652304,222,1,receive,262794858074,1794230
262796652973,826,1,receive,262794888886,1764087
262796653634,908,1,receive,262794887953,1765681
262796654276,916,1,receive,262794895909,1758367
262796654905,898,1,receive,262794897612,1757293
262796750314,206,1,receive,262794894084,1856230
262796750987,906,1,receive,262794896323,1854664
262796751634,176,1,receive,262794885163,1866471
262796752290,850,1,receive,262794880639,1871651
262796752929,702,1,receive,262794859037,1893892
262796872741,920,1,receive,262794906037,1966704
262796873398,904,1,receive,262794898967,1974431
262796874108,104,1,receive,262794693040,2181068
262796874782,894,1,receive,262794910035,1964747
262796875444,714,1,receive,262794869932,2005512
262797017600,432,2,receive,262794897567,2120033
262797018281,362,1,receive,262794890412,2127869
262797018931,74,2,receive,262794891949,2126982
262797019596,138,1,receive,262794906230,2113366
262797020280,872,1,receive,262794868647,2151633
262797020949,926,1,receive,262794922243,2098706
262797131756,860,1,receive,262794864783,2266973
262797132423,928,1,receive,262794926348,2206075
262797133071,922,1,receive,262794927383,2205688
262797133727,442,2,receive,262794921009,2212718
262797134382,172,1,receive,262794871811,2262571
262797251751,152,1,receive,262794921274,2330477
262797252438,820,2,receive,262794926445,2325993
262797253119,562,1,receive,262794948009,2305110
262797253794,378,1,receive,262794945663,2308131
262797254470,114,1,receive,262794899455,2355015
262797353281,758,2,receive,262794953280,2400001
262797353931,110,2,receive,262794921860,2432071
262797354578,148,1,receive,262794843310,2511268
262797394085,772,1,receive,262794960625,2433460
262797394723,212,2,receive,262794923249,2471474
262797489386,354,2,receive,262794884812,2604574
262797490088,938,1,receive,262794965518,2524570
262797490693,736,2,receive,262794901012,2589681
262797491342,934,1,receive,262794966837,2524505
262797492018,580,2,receive,262794955918,2536100
262797492692,888,2,receive,262794981489,2511203
262797603975,956,1,receive,262794984049,2619926
262797604770,508,2,receive,262794961472,2643298
262797605446,262,2,receive,262794986507,2618939
262797606128,962,1,receive,262794987230,2618898
262797606800,220,1,receive,262794979264,2627536
262797722919,838,2,receive,262794990251,2732668
262797723575,930,1,receive,262794990426,2733149
262797724232,700,2,receive,262794990760,2733472
262797724861,418,1,receive,262794895366,2829495
262797725529,12,2,receive,262794920545,2804984
262797844210,958,1,receive,262794999239,2844971
262797844862,964,1,receive,262795001085,2843777
262797845517,954,1,receive,262795002131,2843386
262797846169,948,1,receive,262795005276,2840893
262797887430,950,1,receive,262795006730,2880700
262797974100,944,1,receive,262795008940,2965160
262797974759,952,1,receive,262795010977,2963782
262797975438,358,2,receive,262795011078,2964360
262797976123,942,1,receive,262795012579,2963544
262797976797,20,2,receive,262794917166,3059631
262798079500,946,1,receive,262795013041,3066459
262798080190,404,1,receive,262795004819,3075371
262798080827,960,1,receive,262795017037,3063790
262798081477,162,2,receive,262795004120,3077357
262798082135,586,2,receive,262795027329,3054806
262798082805,98,2,receive,262794964568,3118237
262798218813,940,1,receive,262795036121,3182692
262798219477,210,2,receive,262794982172,3237305
262798220140,78,2,receive,262795022226,3197914
262798220790,830,2,receive,262794976027,3244763
262798221455,422,2,receive,262794986217,3235238
262798350654,132,2,receive,262794906265,3444389
262798351338,160,2,receive,262795016847,3334491
262798352017,918,2,receive,262795049131,3302886
262798352690,794,2,receive,262795023196,3329494
262798353366,112,2,receive,262795056133,3297233
262798476364,976,1,receive,262795073341,3403023
262798477042,932,1,receive,262795063596,3413446
262798477718,364,2,receive,262795067571,3410147
262798478388,982,1,receive,262795079056,3399332
262798479048,984,1,receive,262795081846,3397202
262798479704,276,2,receive,262795039009,3440695
262798590537,520,2,receive,262795005006,3585531
262798591191,532,2,receive,262794950393,3640798
262798591827,858,2,receive,262795060530,3531297
262798622646,50,2,receive,262795070087,3552559
262798697335,534,2,receive,262795001570,3695765
262798697991,366,2,receive,262795001827,3696164
262798698647,902,2,receive,262795074010,3624637
262798699339,768,2,receive,262795088944,3610395
262798700013,142,2,receive,262795092212,3607801
262798700688,834,2,receive,262795077081,3623607
262798820874,972,1,receive,262795096706,3724168
262798821502,26,2,receive,262795026885,3794617
262798822165,88,2,receive,262795033006,3789159
262798822827,970,1,receive,262795098258,3724569
262798823470,568,2,receive,262795021119,3802351
262798941138,380,2,receive,262795017297,3923841
262798941808,988,1,receive,262795103063,3838745
262798942466,488,2,receive,262794998425,3944041
262798943104,536,2,receive,262795056071,3887033
262798986446,968,1,receive,262795108099,3878347
262799064737,974,1,receive,262795108579,3956158
262799065381,986,1,receive,262795109127,3956254
262799066030,980,1,receive,262795113334,3952696
262799066682,178,2,receive,262795086010,3980672
262799067339,996,1,receive,262795116543,3950796
262799186026,886,2,receive,262795051291,4134735
262799186715,82,2,receive,262795037400,4149315
262799187397,966,1,receive,262795122559,4064838
262799188024,382,1,receive,262795125558,4062466
262799188675,494,2,receive,262795094268,4094407
262799189344,952,2,receive,262795130580,4058764
262799336340,978,1,receive,262795121129,4215211
262799337027,994,1,receive,262795136986,4200041
262799337674,52,2,receive,262795086293,4251381
262799338352,992,1,receive,262795141061,4197291
262799339032,556,2,receive,262795067005,4272027
262799442797,998,1,receive,262795151122,4291675
262799443453,990,1,receive,262795143046,4300407
262799444103,134,2,receive,262795112506,4331597
262799444742,384,2,receive,262795049007,4395735
262799445402,120,2,receive,262795115113,4330289
262799565401,42,2,receive,262794953452,4611949
262799566087,594,2,receive,262795128109,4437978
262799566726,372,2,receive,262795117342,4449384
262799567614,936,1,receive,262795163022,4404592
262799568237,166,2,receive,262795160380,4407857
262799568857,274,2,receive,262795127683,4441174
262799685649,164,2,receive,262795098347,4587302
262799686328,354,3,receive,262795164104,4522224
262799686999,480,2,receive,262795083207,4603792
262799687679,64,2,receive,262795108346,4579333
262799688332,702,2,receive,262795104028,4584304
262799688982,790,2,receive,262795139013,4549969
262799809647,890,2,receive,262795181759,4627888
262799810303,848,2,receive,262795104007,4706296
262799810952,736,3,receive,262795155175,4655777
262799811620,772,2,receive,262795183574,4628046
262799890615,234,2,receive,262794962090,4928525
262799891298,150,2,receive,262795192006,4699292
262799891975,810,2,receive,262795172580,4719395
262799892654,428,2,receive,262795178010,4714644
262799893316,842,2,receive,262795157008,4736308
262799893991,870,2,receive,262795191036,4702955
262800008664,538,2,receive,262795169780,4838884
262800009315,122,2,receive,262795151020,4858295
262800009989,866,2,receive,262795217068,4792921
262800010662,244,2,receive,262795151315,4859347
262800094479,144,1,receive,262795217066,4877413
262800095159,948,2,receive,262795219572,4875587
262800095829,46,2,receive,262795174774,4921055
262800096496,60,2,receive,262795028316,5068180
262800097157,938,2,receive,262795200017,4897140
262800097829,880,2,receive,262795130518,4967311
262800209805,86,2,receive,262795156011,5053794
262800210488,722,2,receive,262795202016,5008472
262800211164,184,2,receive,262795188876,5022288
262800211819,1000,1,receive,262795235958,4975861
262800212487,778,2,receive,262795225615,4986872
262800312148,358,3,receive,262795158156,5153992
262800312773,14,2,receive,262795227167,5085606
262800313435,854,2,receive,262795025945,5287490
262800314116,62,2,receive,262795198065,5116051
262800410025,874,2,receive,262795207780,5202245
262800410682,128,2,receive,262795211230,5199452
262800411335,348,2,receive,262795126019,5285316
262800411986,236,2,receive,262795176062,5235924
262800448808,698,2,receive,262795182874,5265934
262800449482,976,2,receive,262795242365,5207117
262800549163,542,2,receive,262795202559,5346604
262800550058,34,2,receive,262795224006,5326052
262800550710,896,2,receive,262795262010,5288700
262800551380,198,2,receive,262795175713,5375667
262800552059,6,2,receive,262795222621,5329438
262800552732,754,2,receive,262795279349,5273383
262800664418,720,2,receive,262795182834,5481584
262800665076,186,2,receive,262795255131,5409945
262800665750,682,2,receive,262795174077,5491673
262800666411,76,2,receive,262795242141,5424270
262800667090,954,2,receive,262795186367,5480723
262800667753,80,2,receive,262795265363,5402390
262800772699,168,2,receive,262795223810,5548889
262800773381,586,3,receive,262795298077,5475304
262800774038,840,2,receive,262795288011,5486027
262800774671,262,3,receive,262795303009,5471662
262800775312,958,2,receive,262795271506,5503806
262800775960,618,2,receive,262795192141,5583819
262800870332,590,2,receive,262795291956,5578376
262800870997,508,3,receive,262795299362,5571635
262800871675,670,2,receive,262795315688,5555987
262800872343,940,2,receive,262795298578,5573765
262800872994,580,3,receive,262795239149,5633845
262800961017,442,3,receive,262795317101,5643916
262800961689,222,2,receive,262795262006,5699683
262800962372,116,2,receive,262795283474,5678898
262800963046,704,2,receive,262795281568,5681478
262800963721,202,2,receive,262795211565,5752156
262801066322,230,2,receive,262795316860,5749462
262801066973,88,3,receive,262795262006,5804967
262801067632,54,2,receive,262795312072,5755560
262801068306,24,2,receive,262795265106,5803200
262801068976,356,2,receive,262795334689,5734287
262801144674,994,2,receive,262795279482,5865192
262801145329,972,2,receive,262795335015,5810314
262801145979,932,2,receive,262795362451,5783528
262801172297,716,2,receive,262795286512,5885785
262801172967,978,2,receive,262795291139,5881828
262801231861,480,3,receive,262795365448,5866413
262801232602,876,2,receive,262795299282,5933320
262801233281,50,3,receive,262795387475,5845806
262801233960,26,3,receive,262795375402,5858558
262801234629,352,2,receive,262795333283,5901346
262801333602,432,3,receive,262795371008,5962594
262801334262,244,3,receive,262795375374,5958888
262801334913,392,2,receive,262795450629,5884284
262801353204,138,2,receive,262795500064,5853140
262801354810,930,2,receive,262795446115,5908695
262801410498,824,2,receive,262795491367,5919131
262801411175,578,2,receive,262795561339,5849836
262801413387,588,2,receive,262795586010,5827377
262801427542,398,2,receive,262795615009,5812533
262801495019,734,2,receive,262795601499,5893520
262801495696,802,2,receive,262795544016,5951680
262801496375,44,2,receive,262795703006,5793369
262801500339,520,3,receive,262795590006,5910333
262801501018,552,2,receive,262795725289,5775729
262801501690,832,2,receive,262795689345,5812345
262801601623,52,3,receive,262795705088,5896535
262801602309,578,3,receive,262795728800,5873509
262801602973,84,2,receive,262795765033,5837940
262801603643,356,3,receive,262795725510,5878133
262801604319,172,2,receive,262795785283,5819036
262801604979,244,4,receive,262795779350,5825629
262801693894,376,3,receive,262795837664,5856230
262801694547,86,4,receive,262795886361,5808186
262801708312,950,3,receive,262795823548,5884764
262801717416,288,1,receive,262795894335,5823081
262801760447,858,3,receive,262795835454,5924993
262801761123,202,3,receive,262795984984,5776139
262801762133,88,4,receive,262796050007,5712126
262801762759,50,5,receive,262796003010,5759749
262801763404,108,3,receive,262796044273,5719131
