receive_timestamp,source_vehicle,message_id,event_type,send_timestamp,latency_us
373279651,130,1,receive,373230125,49526
373280111,108,1,receive,373231840,48271
373280521,34,4,receive,373232773,47748
373280931,12,1,receive,373233415,47516
373281326,146,1,receive,373235434,45892
373281732,170,1,receive,373236911,44821
373282143,88,1,receive,373237445,44698
373282557,12,2,receive,373237933,44624
373282970,208,1,receive,373238414,44556
373283386,64,2,receive,373238524,44862
373283816,156,1,receive,373240057,43759
373284228,26,2,receive,373233161,51067
373284640,78,3,receive,373240961,43679
373285056,20,3,receive,373241051,44005
373285482,114,1,receive,373243393,42089
373285906,26,3,receive,373242977,42929
373286337,184,1,receive,373244281,42056
373286754,44,4,receive,373244365,42389
373504941,152,1,receive,373244303,260638
373505355,70,4,receive,373234554,270801
373505749,196,1,receive,373244839,260910
373506143,202,1,receive,373245191,260952
373506552,110,1,receive,373246363,260189
373506977,130,2,receive,373247303,259674
373507464,16,2,receive,373248215,259249
373507822,106,1,receive,373248258,259564
373508240,182,2,receive,373248814,259426
373508650,128,1,receive,373248918,259732
373751098,58,3,receive,373249671,501427
373751579,10,1,receive,373250106,501473
373752029,90,1,receive,373250077,501952
373752476,74,3,receive,373250725,501751
373752990,38,3,receive,373241428,511562
373753469,184,2,receive,373252728,500741
373955258,82,1,receive,373253177,702081
373955663,72,3,receive,373236969,718694
373956107,156,2,receive,373254574,701533
373956548,8,3,receive,373254823,701725
373957016,126,1,receive,373255577,701439
373957457,40,3,receive,373255919,701538
373957923,6,3,receive,373245051,712872
373958464,74,4,receive,373256025,702439
373958926,168,1,receive,373256251,702675
373959373,128,2,receive,373258107,701266
374176047,186,2,receive,373259077,916970
374176540,4,4,receive,373258886,917654
374176991,12,3,receive,373259914,917077
374177439,32,2,receive,373250011,927428
374177886,104,1,receive,373260181,917705
374178357,92,1,receive,373260118,918239
374178807,114,2,receive,373260429,918378
374179257,172,1,receive,373260499,918758
374179708,66,6,receive,373256207,923501
374180166,144,1,receive,373260632,919534
374406734,8,4,receive,373257755,1148979
374407223,112,1,receive,373262148,1145075
374407686,40,4,receive,373262494,1145192
374408150,206,1,receive,373262711,1145439
374408632,96,1,receive,373262913,1145719
374409118,150,1,receive,373264523,1144595
374409589,208,2,receive,373264969,1144620
374410067,14,6,receive,373264854,1145213
374410539,590,1,receive,373266097,1144442
374411000,14,7,receive,373267806,1143194
374651931,140,1,receive,373270021,1381910
374652460,22,1,receive,373270029,1382431
374652970,18,1,receive,373270036,1382934
374653496,202,2,receive,373270712,1382784
374654066,60,1,receive,373270683,1383383
374654591,160,1,receive,373270910,1383681
374655158,20,4,receive,373261219,1393939
374655818,590,2,receive,373272425,1383393
374656363,172,2,receive,373273789,1382574
374656887,128,3,receive,373275202,1381685
374872063,456,1,receive,373276083,1595980
374872525,196,2,receive,373276902,1595623
374873304,188,1,receive,373276852,1596452
374873759,110,2,receive,373277086,1596673
374874338,184,3,receive,373277380,1596958
374874819,162,1,receive,373277349,1597470
374875244,20,5,receive,373276963,1598281
374875665,12,4,receive,373278229,1597436
375100764,164,1,receive,373272121,1828643
375101273,394,1,receive,373278752,1822521
375101780,82,2,receive,373266117,1835663
375102234,34,5,receive,373244407,1857827
375102711,40,5,receive,373278855,1823856
375103211,230,1,receive,373279031,1824180
375103684,492,1,receive,373279049,1824635
375104587,570,1,receive,373279141,1825446
375331336,36,1,receive,373280391,2050945
375331852,152,2,receive,373281154,2050698
375332359,88,2,receive,373263989,2068370
375332877,52,3,receive,373248117,2084760
375333413,154,1,receive,373286200,2047213
375333923,186,3,receive,373272645,2061278
375334460,196,3,receive,373287096,2047364
375334966,114,3,receive,373287285,2047681
375335490,96,2,receive,373287418,2048072
375335997,76,3,receive,373251724,2084273
375549465,590,3,receive,373289408,2260057
375549939,636,1,receive,373289341,2260598
375550430,778,1,receive,373289648,2260782
375550897,86,1,receive,373290793,2260104
375551379,98,1,receive,373291041,2260338
375551847,868,1,receive,373291114,2260733
375552316,590,4,receive,373292667,2259649
375552778,104,2,receive,373292892,2259886
375553263,90,2,receive,373293038,2260225
375782521,778,2,receive,373293094,2489427
375782986,432,1,receive,373294811,2488175
375783435,68,1,receive,373294917,2488518
375783925,346,1,receive,373295462,2488463
375784377,320,1,receive,373296620,2487757
375784835,108,2,receive,373288603,2496232
375785340,84,1,receive,373282609,2502731
375785803,84,2,receive,373297268,2488535
375786275,302,1,receive,373297189,2489086
375786740,612,1,receive,373297315,2489425
376017169,150,2,receive,373297382,2719787
376017659,974,1,receive,373292613,2725046
376018124,674,1,receive,373297959,2720165
376018566,106,2,receive,373298141,2720425
376019048,778,3,receive,373298369,2720679
376019495,104,3,receive,373300144,2719351
376019950,98,2,receive,373301015,2718935
376020435,152,3,receive,373301213,2719222
376020921,384,1,receive,373301901,2719020
376021369,86,2,receive,373303095,2718274
376244723,448,1,receive,373303372,2941351
376245195,486,1,receive,373304542,2940653
376245659,42,3,receive,373242320,3003339
376246145,160,2,receive,373306687,2939458
376246619,426,1,receive,373306585,2940034
376247092,634,1,receive,373308105,2938987
376247547,408,1,receive,373308867,2938680
376248002,870,1,receive,373309486,2938516
376248486,210,1,receive,373310039,2938447
376248957,26,4,receive,373245006,3003951
376479476,114,4,receive,373311673,3167803
376479954,64,3,receive,373282318,3197636
376480447,30,1,receive,373312619,3167828
376480931,196,4,receive,373313394,3167537
376481409,408,2,receive,373314436,3166973
376481873,974,2,receive,373314787,3167086
376482358,140,2,receive,373316070,3166288
376482818,104,4,receive,373316474,3166344
376483284,184,4,receive,373316662,3166622
376483739,166,1,receive,373316885,3166854
376710965,128,4,receive,373317077,3393888
376711446,790,1,receive,373318464,3392982
376711961,50,1,receive,373318434,3393527
376712439,798,1,receive,373318566,3393873
376712927,196,5,receive,373318774,3394153
376713399,54,1,receive,373318997,3394402
376713871,202,3,receive,373294291,3419580
376714350,18,2,receive,373320016,3394334
376714815,80,1,receive,373322157,3392658
376715283,86,3,receive,373322441,3392842
376941855,400,1,receive,373323456,3618399
376942314,122,1,receive,373296841,3645473
376942775,158,1,receive,373304081,3638694
376943223,230,2,receive,373326675,3616548
376943743,320,2,receive,373327062,3616681
376944243,98,3,receive,373323391,3620852
376944759,384,2,receive,373330017,3614742
376945320,252,1,receive,373331018,3614302
376945808,634,2,receive,373331441,3614367
376946278,632,1,receive,373332263,3614015
377156667,118,1,receive,373332253,3824414
377157097,6,4,receive,373278304,3878793
377157561,90,3,receive,373332855,3824706
377158009,818,1,receive,373332891,3825118
377158469,90,4,receive,373333221,3825248
377158917,400,2,receive,373333307,3825610
377159381,150,3,receive,373334297,3825084
377159831,154,2,receive,373334689,3825142
377160293,44,5,receive,373273715,3886578
377373396,758,1,receive,373334743,4038653
377373864,486,2,receive,373334774,4039090
377374328,182,3,receive,373296292,4078036
377374774,206,2,receive,373335639,4039135
377375217,972,1,receive,373336349,4038868
377375684,798,2,receive,373336605,4039079
377376146,728,1,receive,373337175,4038971
377376591,152,4,receive,373321810,4054781
377377063,58,4,receive,373280331,4096732
377377679,670,1,receive,373337448,4040231
377590675,132,1,receive,373337427,4253248
377591134,766,1,receive,373337608,4253526
377591571,84,3,receive,373324172,4267399
377592022,312,1,receive,373339142,4252880
377592472,312,2,receive,373339616,4252856
377592928,100,1,receive,373257727,4335201
377593375,96,3,receive,373340772,4252603
377593831,274,1,receive,373342284,4251547
377594276,204,1,receive,373342449,4251827
377811679,188,2,receive,373340656,4471023
377812153,426,2,receive,373343822,4468331
377812593,408,3,receive,373344177,4468416
377813055,338,1,receive,373344313,4468742
377813563,18,3,receive,373343300,4470263
377814016,12,5,receive,373315677,4498339
377814469,138,1,receive,373345262,4469207
377814927,626,1,receive,373345494,4469433
377815375,110,3,receive,373345744,4469631
377815819,590,5,receive,373345797,4470022
378012191,782,1,receive,373346124,4666067
378012643,160,3,receive,373346421,4666222
378013092,290,1,receive,373311159,4701933
378013536,964,1,receive,373346825,4666711
378013993,96,4,receive,373346856,4667137
378014461,432,2,receive,373347684,4666777
378014904,670,2,receive,373349026,4665878
378015342,632,2,receive,373350024,4665318
378015780,106,3,receive,373351343,4664437
378016218,708,1,receive,373351772,4664446
378237385,158,2,receive,373351916,4885469
378237839,150,4,receive,373352784,4885055
378238314,284,1,receive,373353815,4884499
378238806,70,5,receive,373288342,4950464
378239337,426,3,receive,373354781,4884556
378239817,868,2,receive,373354805,4885012
378240272,730,1,receive,373355393,4884879
378240710,206,3,receive,373355353,4885357
378241154,1000,1,receive,373355649,4885505
378433627,382,1,receive,373356097,5077530
378434068,320,3,receive,373357048,5077020
378434524,80,2,receive,373357455,5077069
378434974,36,2,receive,373357977,5076997
378435409,56,3,receive,373241375,5194034
378435865,490,1,receive,373358269,5077596
378436375,400,3,receive,373358854,5077521
378436857,554,1,receive,373359320,5077537
378437309,598,1,receive,373359649,5077660
378437784,104,5,receive,373360476,5077308
378621548,212,1,receive,373360429,5261119
378621990,818,2,receive,373360893,5261097
378622426,128,5,receive,373361359,5261067
378622857,190,1,receive,373362713,5260144
378623317,764,1,receive,373362713,5260604
378623767,210,2,receive,373363083,5260684
378624215,230,3,receive,373364522,5259693
378624668,778,4,receive,373364429,5260239
378625130,592,1,receive,373364608,5260522
378811132,488,1,receive,373367149,5443983
378811614,426,4,receive,373367583,5444031
378812185,332,1,receive,373367726,5444459
378812658,354,1,receive,373368455,5444203
378813120,114,5,receive,373368894,5444226
378813572,582,1,receive,373368957,5444615
378814009,86,4,receive,373369044,5444965
378814480,640,1,receive,373369448,5445032
378814940,166,2,receive,373358761,5456179
378815393,300,1,receive,373370044,5445349
379029140,192,1,receive,373370182,5658958
379029625,712,1,receive,373370313,5659312
379030082,486,3,receive,373371338,5658744
379030480,130,3,receive,373309045,5721435
379030941,524,1,receive,373374149,5656792
379031402,130,4,receive,373373933,5657469
379031861,530,1,receive,373374600,5657261
379032301,436,1,receive,373374829,5657472
379032749,130,5,receive,373375029,5657720
379033210,636,2,receive,373376013,5657197
379223676,90,5,receive,373376866,5846810
379224136,508,1,receive,373376887,5847249
379224598,130,6,receive,373376476,5848122
379225047,972,2,receive,373377276,5847771
379225518,426,5,receive,373377644,5847874
379225988,634,3,receive,373378345,5847643
379226462,918,1,receive,373378463,5847999
379226958,618,1,receive,373379066,5847892
379227433,166,3,receive,373380013,5847420
379392780,112,2,receive,373285041,6107739
379393238,196,6,receive,373381922,6011316
379393694,868,3,receive,373382063,6011631
379394147,90,6,receive,373382316,6011831
379394610,8,5,receive,373278178,6116432
379395109,400,4,receive,373382781,6012328
379395566,340,1,receive,373296934,6098632
379396015,486,4,receive,373383975,6012040
379396530,432,3,receive,373383008,6013522
379396973,126,2,receive,373305048,6091925
379558306,222,1,receive,373375932,6182374
379558777,316,1,receive,373386209,6172568
379559219,486,5,receive,373386787,6172432
379559805,730,2,receive,373387278,6172527
379560272,2,5,receive,373273391,6286881
379560771,154,3,receive,373388709,6172062
379561231,734,1,receive,373389539,6171692
379561687,444,1,receive,373334200,6227487
379562146,436,2,receive,373390018,6172128
379714656,492,2,receive,373390020,6324636
379715125,638,1,receive,373371725,6343400
379715604,366,1,receive,373390145,6325459
379716094,618,2,receive,373390437,6325657
379716546,62,4,receive,373250337,6466209
379716998,774,1,receive,373390624,6326374
379717449,756,1,receive,373390885,6326564
379717943,554,2,receive,373391272,6326671
379718389,196,7,receive,373391318,6327071
379718852,678,1,receive,373391717,6327135
379874471,964,2,receive,373391772,6482699
379874936,724,1,receive,373392160,6482776
379875391,64,4,receive,373354344,6521047
379875862,488,2,receive,373393759,6482103
379876320,798,3,receive,373393968,6482352
379876773,320,4,receive,373394395,6482378
379877227,222,2,receive,373395466,6481761
379877828,778,5,receive,373395541,6482287
379878294,778,6,receive,373395881,6482413
380024801,32,3,receive,373285087,6739714
380025267,206,4,receive,373396720,6628547
380025725,336,1,receive,373396941,6628784
380026202,2,6,receive,373393761,6632441
380026673,766,2,receive,373397603,6629070
380027128,352,1,receive,373355333,6671795
380027604,164,2,receive,373287511,6740093
380028081,434,1,receive,373398867,6629214
380028700,804,1,receive,373398932,6629768
380184655,456,2,receive,373399942,6784713
380185250,858,1,receive,373343766,6841484
380185700,612,2,receive,373391742,6793958
380186168,150,5,receive,373400589,6785579
380186613,560,1,receive,373401198,6785415
380187073,330,1,receive,373400981,6786092
380187513,564,1,receive,373401672,6785841
380187982,204,2,receive,373401651,6786331
380188425,478,3,receive,373511817,6676608
380188869,382,3,receive,373512317,6676552
380326994,10,2,receive,373288642,7038352
380327451,274,5,receive,373512832,6814619
380327919,598,4,receive,373512971,6814948
380328372,230,8,receive,373513368,6815004
380328831,486,9,receive,373514418,6814413
380329267,348,2,receive,373514585,6814682
380329705,356,2,receive,373514730,6814975
380330169,818,4,receive,373515121,6815048
380330604,934,6,receive,373752030,6578574
380331043,580,4,receive,373752181,6578862
380438441,854,7,receive,373752857,6685584
380438901,150,13,receive,373620387,6818514
380439357,266,8,receive,373753773,6685584
380439799,266,9,receive,373754906,6684893
380440275,742,4,receive,373755368,6684907
380440733,530,3,receive,373487103,6953630
380441177,618,11,receive,373816981,6624196
380441625,590,6,receive,373376421,7065204
380442072,22,2,receive,373372896,7069176
380545029,618,12,receive,373957733,6587296
380545497,982,15,receive,373910550,6634947
380545950,62,6,receive,373820092,6725858
380546421,228,7,receive,373726663,6819758
380547019,330,6,receive,373768350,6778669
380547551,558,1,receive,373573335,6974216
380548264,522,9,receive,373918028,6630236
380548784,160,6,receive,373935557,6613227
380653811,750,6,receive,374094092,6559719
380654245,794,3,receive,373992994,6661251
380654650,234,3,receive,373968714,6685936
380655023,758,4,receive,374009769,6645254
380655427,32,7,receive,373943160,6712267
380655920,122,9,receive,373935849,6720071
380656629,674,4,receive,374127688,6528941
380657206,96,7,receive,373990640,6666566
380657930,848,9,receive,374211621,6446309
380769633,674,5,receive,374214463,6555170
380770133,400,11,receive,374194928,6575205
380770594,620,7,receive,374200913,6569681
380771133,662,8,receive,374209789,6561344
380771755,344,7,receive,374179358,6592397
380772248,348,9,receive,374197043,6575205
380772758,406,2,receive,373900154,6872604
380773175,498,12,receive,374196516,6576659
380773705,96,8,receive,374232402,6541303
380882355,562,4,receive,374440398,6441957
380882829,188,7,receive,374431357,6451472
380883291,800,6,receive,374473162,6410129
380883769,160,8,receive,374393924,6489845
380884426,940,12,receive,374372551,6511875
380884916,102,6,receive,374426508,6458408
380885412,496,10,receive,374656489,6228923
380886170,130,11,receive,374475241,6410929
380886642,192,8,receive,374459177,6427465
380998535,416,12,receive,374625770,6372765
380999037,212,7,receive,374682489,6316548
380999532,702,14,receive,374623785,6375747
381000026,546,4,receive,374599302,6400724
381000536,50,7,receive,374681365,6319171
381001020,126,9,receive,374659595,6341425
381001581,836,8,receive,374668984,6332597
381002048,2,15,receive,374687152,6314896
381002590,918,8,receive,374874879,6127711
381003081,590,9,receive,374816773,6186308
381125753,590,10,receive,375103135,6022618
381126251,254,6,receive,374883909,6242342
381126737,700,6,receive,374872125,6254612
381127219,826,7,receive,374891646,6235573
381127721,734,15,receive,374709281,6418440
381128219,60,6,receive,374863997,6264222
381129275,254,7,receive,375104602,6024673
381129759,506,14,receive,375103343,6026416
381245778,574,17,receive,375054255,6191523
381246894,606,26,receive,375075994,6170900
