receive_timestamp,source_vehicle,message_id,event_type,send_timestamp,latency_us
373400180,34,4,receive,373232773,167407
373400682,12,1,receive,373233415,167267
373401157,146,1,receive,373235434,165723
373401622,170,1,receive,373236911,164711
373402082,88,1,receive,373237445,164637
373402552,12,2,receive,373237933,164619
373403016,208,1,receive,373238414,164602
373403468,64,2,receive,373238524,164944
373403931,156,1,receive,373240057,163874
373404386,26,2,receive,373233161,171225
373793616,78,3,receive,373240961,552655
373794065,20,3,receive,373241051,553014
373794544,114,1,receive,373243393,551151
373795008,26,3,receive,373242977,552031
373795441,184,1,receive,373244281,551160
373795903,44,4,receive,373244365,551538
373796354,152,1,receive,373244303,552051
373796814,70,4,receive,373234554,562260
373797250,196,1,receive,373244839,552411
373797672,202,1,receive,373245191,552481
373798113,110,1,receive,373246363,551750
373903871,130,2,receive,373247303,656568
373904312,16,2,receive,373248215,656097
373904759,106,1,receive,373248258,656501
373905206,182,2,receive,373248814,656392
373905675,128,1,receive,373248918,656757
373906135,58,3,receive,373249671,656464
373906573,90,1,receive,373250077,656496
373907025,10,1,receive,373250106,656919
373907472,74,3,receive,373250725,656747
373907930,38,3,receive,373241428,666502
374135352,184,2,receive,373252728,882624
374135806,82,1,receive,373253177,882629
374136283,72,3,receive,373236969,899314
374136740,156,2,receive,373254574,882166
374137188,8,3,receive,373254823,882365
374137634,126,1,receive,373255577,882057
374138096,40,3,receive,373255919,882177
374138537,6,3,receive,373245051,893486
374138983,74,4,receive,373256025,882958
374139427,168,1,receive,373256251,883176
374352450,128,2,receive,373258107,1094343
374352931,186,2,receive,373259077,1093854
374353377,4,4,receive,373258886,1094491
374353846,12,3,receive,373259914,1093932
374354296,32,2,receive,373250011,1104285
374354725,92,1,receive,373260118,1094607
374355209,104,1,receive,373260181,1095028
374355641,114,2,receive,373260429,1095212
374356071,172,1,receive,373260499,1095572
374356587,66,6,receive,373256207,1100380
374581519,144,1,receive,373260632,1320887
374581931,8,4,receive,373257755,1324176
374582319,112,1,receive,373262148,1320171
374582742,40,4,receive,373262494,1320248
374583177,206,1,receive,373262711,1320466
374583577,96,1,receive,373262913,1320664
374583966,150,1,receive,373264523,1319443
374584366,208,2,receive,373264969,1319397
374584758,14,6,receive,373264854,1319904
374585202,590,1,receive,373266097,1319105
374585613,14,7,receive,373267806,1317807
374586014,140,1,receive,373270021,1315993
374839781,22,1,receive,373270029,1569752
374840321,18,1,receive,373270036,1570285
374840808,202,2,receive,373270712,1570096
374841254,60,1,receive,373270683,1570571
374841723,160,1,receive,373270910,1570813
374842223,20,4,receive,373261219,1581004
374842661,590,2,receive,373272425,1570236
374843082,172,2,receive,373273789,1569293
374843602,128,3,receive,373275202,1568400
374844084,456,1,receive,373276083,1568001
375074595,196,2,receive,373276902,1797693
375075058,188,1,receive,373276852,1798206
375075503,110,2,receive,373277086,1798417
375075980,184,3,receive,373277380,1798600
375076476,162,1,receive,373277349,1799127
375076927,20,5,receive,373276963,1799964
375077386,12,4,receive,373278229,1799157
375077856,164,1,receive,373272121,1805735
375078307,394,1,receive,373278752,1799555
375079401,82,2,receive,373266117,1813284
375388649,34,5,receive,373244407,2144242
375389109,40,5,receive,373278855,2110254
375389558,230,1,receive,373279031,2110527
375390021,492,1,receive,373279049,2110972
375390469,570,1,receive,373279141,2111328
375390918,36,1,receive,373280391,2110527
375391375,152,2,receive,373281154,2110221
375391828,88,2,receive,373263989,2127839
375392274,52,3,receive,373248117,2144157
375392757,154,1,receive,373286200,2106557
375607782,186,3,receive,373272645,2335137
375608252,196,3,receive,373287096,2321156
375608721,114,3,receive,373287285,2321436
375609221,96,2,receive,373287418,2321803
375609702,76,3,receive,373251724,2357978
375610200,590,3,receive,373289408,2320792
375610683,636,1,receive,373289341,2321342
375611155,778,1,receive,373289648,2321507
375611623,86,1,receive,373290793,2320830
375826173,98,1,receive,373291041,2535132
375826666,868,1,receive,373291114,2535552
375827122,590,4,receive,373292667,2534455
375827596,104,2,receive,373292892,2534704
375828091,90,2,receive,373293038,2535053
375828558,778,2,receive,373293094,2535464
375829023,432,1,receive,373294811,2534212
375829502,68,1,receive,373294917,2534585
375830006,346,1,receive,373295462,2534544
375830486,320,1,receive,373296620,2533866
376065222,108,2,receive,373288603,2776619
376065690,84,1,receive,373282609,2783081
376066168,84,2,receive,373297268,2768900
376066636,302,1,receive,373297189,2769447
376067115,612,1,receive,373297315,2769800
376067579,150,2,receive,373297382,2770197
376068059,974,1,receive,373292613,2775446
376068525,674,1,receive,373297959,2770566
376069003,106,2,receive,373298141,2770862
376069462,778,3,receive,373298369,2771093
376315715,104,3,receive,373300144,3015571
376316145,98,2,receive,373301015,3015130
376316560,152,3,receive,373301213,3015347
376317051,384,1,receive,373301901,3015150
376317526,86,2,receive,373303095,3014431
376317948,448,1,receive,373303372,3014576
376318363,486,1,receive,373304542,3013821
376318770,42,3,receive,373242320,3076450
376319175,160,2,receive,373306687,3012488
376319670,426,1,receive,373306585,3013085
376320097,634,1,receive,373308105,3011992
376579548,408,1,receive,373308867,3270681
376579990,870,1,receive,373309486,3270504
376580421,210,1,receive,373310039,3270382
376580868,26,4,receive,373245006,3335862
376581294,114,4,receive,373311673,3269621
376581698,64,3,receive,373282318,3299380
376582088,30,1,receive,373312619,3269469
376582584,196,4,receive,373313394,3269190
376583052,408,2,receive,373314436,3268616
376583835,974,2,receive,373314787,3269048
376810180,140,2,receive,373316070,3494110
376810648,104,4,receive,373316474,3494174
376811116,184,4,receive,373316662,3494454
376811597,166,1,receive,373316885,3494712
376812074,128,4,receive,373317077,3494997
376812546,790,1,receive,373318464,3494082
376813037,50,1,receive,373318434,3494603
376813501,798,1,receive,373318566,3494935
376813973,196,5,receive,373318774,3495199
376814436,54,1,receive,373318997,3495439
377051993,18,2,receive,373320016,3731977
377052450,202,3,receive,373294291,3758159
377052930,80,1,receive,373322157,3730773
377053379,86,3,receive,373322441,3730938
377053844,400,1,receive,373323456,3730388
377054283,122,1,receive,373296841,3757442
377054764,158,1,receive,373304081,3750683
377055213,230,2,receive,373326675,3728538
377055660,320,2,receive,373327062,3728598
377263191,98,3,receive,373323391,3939800
377263643,384,2,receive,373330017,3933626
377264087,252,1,receive,373331018,3933069
377264532,634,2,receive,373331441,3933091
377265035,632,1,receive,373332263,3932772
377265478,118,1,receive,373332253,3933225
377265933,6,4,receive,373278304,3987629
377266379,90,3,receive,373332855,3933524
377266845,818,1,receive,373332891,3933954
377267289,90,4,receive,373333221,3934068
377501894,400,2,receive,373333307,4168587
377502349,150,3,receive,373334297,4168052
377502810,154,2,receive,373334689,4168121
377503264,44,5,receive,373273715,4229549
377503740,758,1,receive,373334743,4168997
377504196,486,2,receive,373334774,4169422
377504653,182,3,receive,373296292,4208361
377505109,206,2,receive,373335639,4169470
377505566,972,1,receive,373336349,4169217
377713831,798,2,receive,373336605,4377226
377714326,728,1,receive,373337175,4377151
377714824,152,4,receive,373321810,4393014
377715270,58,4,receive,373280331,4434939
377715711,670,1,receive,373337448,4378263
377716168,132,1,receive,373337427,4378741
377716617,766,1,receive,373337608,4379009
377717345,84,3,receive,373324172,4393173
377717884,312,1,receive,373339142,4378742
377956134,312,2,receive,373339616,4616518
377956600,100,1,receive,373257727,4698873
377957053,96,3,receive,373340772,4616281
377957493,274,1,receive,373342284,4615209
377957927,204,1,receive,373342449,4615478
377958372,188,2,receive,373340656,4617716
377958843,426,2,receive,373343822,4615021
377959290,408,3,receive,373344177,4615113
377959740,338,1,receive,373344313,4615427
377960197,18,3,receive,373343300,4616897
378185765,12,5,receive,373315677,4870088
378186251,138,1,receive,373345262,4840989
378186713,626,1,receive,373345494,4841219
378187173,110,3,receive,373345744,4841429
378187621,590,5,receive,373345797,4841824
378188079,782,1,receive,373346124,4841955
378188526,160,3,receive,373346421,4842105
378188962,290,1,receive,373311159,4877803
378189422,964,1,receive,373346825,4842597
378401473,96,4,receive,373346856,5054617
378401941,432,2,receive,373347684,5054257
378402410,670,2,receive,373349026,5053384
378402864,632,2,receive,373350024,5052840
378403322,106,3,receive,373351343,5051979
378403770,708,1,receive,373351772,5051998
378404234,158,2,receive,373351916,5052318
378404692,150,4,receive,373352784,5051908
378405165,284,1,receive,373353815,5051350
378592569,70,5,receive,373288342,5304227
378593049,426,3,receive,373354781,5238268
378593500,868,2,receive,373354805,5238695
378593934,730,1,receive,373355393,5238541
378594404,206,3,receive,373355353,5239051
378594886,1000,1,receive,373355649,5239237
378595344,382,1,receive,373356097,5239247
378595798,320,3,receive,373357048,5238750
378596315,80,2,receive,373357455,5238860
378596770,36,2,receive,373357977,5238793
378795805,56,3,receive,373241375,5554430
378796259,490,1,receive,373358269,5437990
378796710,400,3,receive,373358854,5437856
378797148,554,1,receive,373359320,5437828
378797600,598,1,receive,373359649,5437951
378798096,104,5,receive,373360476,5437620
378798578,212,1,receive,373360429,5438149
378799023,818,2,receive,373360893,5438130
378799482,128,5,receive,373361359,5438123
378799941,190,1,receive,373362713,5437228
378994938,764,1,receive,373362713,5632225
378995428,210,2,receive,373363083,5632345
378995888,230,3,receive,373364522,5631366
378996338,778,4,receive,373364429,5631909
378996800,592,1,receive,373364608,5632192
378997257,488,1,receive,373367149,5630108
378997725,426,4,receive,373367583,5630142
378998181,332,1,receive,373367726,5630455
378998637,354,1,receive,373368455,5630182
379179330,582,1,receive,373368957,5810373
379179796,114,5,receive,373368894,5810902
379180259,86,4,receive,373369044,5811215
379180705,640,1,receive,373369448,5811257
379181167,166,2,receive,373358761,5822406
379181626,300,1,receive,373370044,5811582
379182072,192,1,receive,373370182,5811890
379182520,712,1,receive,373370313,5812207
379182982,486,3,receive,373371338,5811644
379183447,130,3,receive,373309045,5874402
379373349,524,1,receive,373374149,5999200
379373790,130,4,receive,373373933,5999857
379374241,530,1,receive,373374600,5999641
379374679,436,1,receive,373374829,5999850
379375156,130,5,receive,373375029,6000127
379375591,636,2,receive,373376013,5999578
379376056,90,5,receive,373376866,5999190
379376500,508,1,receive,373376887,5999613
379376942,130,6,receive,373376476,6000466
379377384,972,2,receive,373377276,6000108
379549292,426,5,receive,373377644,6171648
379549881,634,3,receive,373378345,6171536
379550357,918,1,receive,373378463,6171894
379550808,618,1,receive,373379066,6171742
379551261,166,3,receive,373380013,6171248
379551714,112,2,receive,373285041,6266673
379552178,196,6,receive,373381922,6170256
379552626,868,3,receive,373382063,6170563
379553183,8,5,receive,373278178,6275005
379553631,90,6,receive,373382316,6171315
379712537,400,4,receive,373382781,6329756
379713011,340,1,receive,373296934,6416077
379713402,486,4,receive,373383975,6329427
379713788,432,3,receive,373383008,6330780
379714171,126,2,receive,373305048,6409123
379714584,222,1,receive,373375932,6338652
379715054,316,1,receive,373386209,6328845
379715508,486,5,receive,373386787,6328721
379715903,730,2,receive,373387278,6328625
379716290,2,5,receive,373273391,6442899
379716673,154,3,receive,373388709,6327964
379877784,734,1,receive,373389539,6488245
379878296,444,1,receive,373334200,6544096
379878791,436,2,receive,373390018,6488773
379879302,492,2,receive,373390020,6489282
379879695,638,1,receive,373371725,6507970
379880113,366,1,receive,373390145,6489968
379880538,618,2,receive,373390437,6490101
379880923,62,4,receive,373250337,6630586
379881356,774,1,receive,373390624,6490732
379881760,756,1,receive,373390885,6490875
379882158,554,2,receive,373391272,6490886
380045840,196,7,receive,373391318,6654522
380046251,678,1,receive,373391717,6654534
380046646,964,2,receive,373391772,6654874
380047046,724,1,receive,373392160,6654886
380047534,64,4,receive,373354344,6693190
380047923,488,2,receive,373393759,6654164
380048350,798,3,receive,373393968,6654382
380048745,320,4,receive,373394395,6654350
380049165,222,2,receive,373395466,6653699
380049558,778,5,receive,373395541,6654017
380049951,778,6,receive,373395881,6654070
380050354,32,3,receive,373285087,6765267
380211266,456,2,receive,373399942,6811324
380211680,150,5,receive,373400589,6811091
380212124,560,1,receive,373401198,6810926
380212518,330,1,receive,373400981,6811537
380212910,222,3,receive,373402437,6810473
380213306,778,7,receive,373402673,6810633
380213780,230,4,receive,373403215,6810565
380214196,586,1,receive,373403229,6810967
380214650,670,3,receive,373403888,6810762
380215050,982,1,receive,373404064,6810986
380215444,554,3,receive,373404704,6810740
380366406,916,1,receive,373533785,6832621
380366821,168,2,receive,373299424,7067397
380367222,734,10,receive,373795344,6571878
380367690,384,4,receive,373616892,6750798
380368140,958,1,receive,373383420,6984720
380368548,412,2,receive,373796683,6571865
380368947,716,2,receive,373574577,6794370
380369353,226,3,receive,373590054,6779299
380369840,16,3,receive,373316667,7053173
380370260,164,4,receive,373688395,6681865
380370645,760,2,receive,373785373,6585272
380488607,450,5,receive,373762824,6725783
380489203,266,11,receive,373815105,6674098
380490097,132,3,receive,373774999,6715098
380490655,748,3,receive,373747821,6742834
380491118,568,1,receive,373575024,6916094
380492079,172,3,receive,373334251,7157828
380492615,978,1,receive,373658662,6833953
380493245,732,6,receive,373810985,6682260
380594579,160,5,receive,373703481,6891098
380595976,334,3,receive,373679227,6916749
380596556,206,6,receive,373921872,6674684
380597003,816,8,receive,373930401,6666602
380597470,808,6,receive,374029248,6568222
380597920,578,4,receive,373916773,6681147
380700192,300,5,receive,373867706,6832486
380700662,214,3,receive,373927368,6773294
380701109,918,4,receive,373886336,6814773
380701564,322,3,receive,373835182,6866382
380702023,140,6,receive,373943010,6759013
380702463,774,6,receive,373949952,6752511
380702920,132,5,receive,374158198,6544722
380703369,158,5,receive,374141674,6561695
380704097,706,3,receive,374133061,6571036
380802222,518,3,receive,374075265,6726957
380802748,564,10,receive,374170253,6632495
380803201,518,4,receive,374354826,6448375
380803678,174,3,receive,374166630,6637048
380804151,304,5,receive,374026862,6777289
380804637,172,5,receive,374168925,6635712
380805111,430,5,receive,374111096,6694015
380805597,24,7,receive,374375589,6430008
380806064,718,4,receive,374362322,6443742
380902904,20,9,receive,374371492,6531412
380903366,524,13,receive,374386515,6516851
380903854,174,4,receive,374385998,6517856
380904329,732,9,receive,374400803,6503526
380905094,18,6,receive,374366563,6538531
380905683,272,9,receive,374371211,6534472
380906149,284,8,receive,374364055,6542094
380906617,218,7,receive,374403393,6503224
381006453,254,4,receive,374353558,6652895
381006984,712,8,receive,374362627,6644357
381007508,60,5,receive,374648450,6359058
381008034,512,5,receive,374591223,6416811
381008625,278,7,receive,374656319,6352306
381009353,272,10,receive,374593186,6416167
381009872,912,8,receive,374623322,6386550
381010408,104,10,receive,374630341,6380067
381010904,816,11,receive,374635475,6375429
381125259,140,9,receive,374626076,6499183
381125779,748,7,receive,374657076,6468703
381126321,396,6,receive,374637228,6489093
381126822,674,8,receive,374902420,6224402
381127318,78,13,receive,374887159,6240159
381127808,814,8,receive,374837614,6290194
381128290,616,9,receive,374823858,6304432
381128800,720,5,receive,374816302,6312498
381129280,598,10,receive,374895493,6233787
381129769,248,8,receive,374690876,6438893
381245556,524,16,receive,374852439,6393117
381246022,314,17,receive,374857848,6388174
