receive_timestamp,source_vehicle,message_id,event_type,send_timestamp,latency_us
262794645277,20,1,receive,262794628394,16883
262794645786,28,1,receive,262794628420,17366
262794667831,46,1,receive,262794628724,39107
262794668369,18,1,receive,262794628617,39752
262794668897,8,1,receive,262794629046,39851
262794669444,34,1,receive,262794629216,40228
262794851190,6,1,receive,262794629238,221952
262794851772,124,1,receive,262794629510,222262
262794852344,38,1,receive,262794629609,222735
262794852922,36,1,receive,262794629900,223022
262794902271,26,1,receive,262794630269,272002
262794902847,66,1,receive,262794630369,272478
262794980962,24,1,receive,262794629183,351779
262794981597,160,1,receive,262794631212,350385
262794982223,42,1,receive,262794631194,351029
262794982841,2,1,receive,262794630980,351861
262794983473,94,1,receive,262794631350,352123
262795112601,112,1,receive,262794631361,481240
262795113262,60,1,receive,262794631516,481746
262795113918,122,1,receive,262794631680,482238
262795114566,74,1,receive,262794631891,482675
262795157161,30,1,receive,262794631961,525200
262795157793,70,1,receive,262794632065,525728
262795240481,22,1,receive,262794632578,607903
262795241168,84,1,receive,262794632626,608542
262795241836,68,1,receive,262794632820,609016
262795278149,48,1,receive,262794632867,645282
262795278822,100,1,receive,262794633176,645646
262795361549,64,1,receive,262794634708,726841
262795362217,102,1,receive,262794636161,726056
262795362868,56,1,receive,262794636706,726162
262795363536,128,1,receive,262794636741,726795
262795364213,72,1,receive,262794637042,727171
262795364886,98,1,receive,262794638100,726786
262795483278,366,1,receive,262794638294,844984
262795483914,398,1,receive,262794638396,845518
262795484565,54,1,receive,262794638424,846141
262795485217,78,1,receive,262794638451,846766
262795485872,118,1,receive,262794639252,846620
262795606856,40,1,receive,262794639832,967024
262795607526,108,1,receive,262794640838,966688
262795608178,86,1,receive,262794641071,967107
262795625655,234,1,receive,262794641428,984227
262795626379,106,1,receive,262794641533,984846
262795739073,428,1,receive,262794641957,1097116
262795739730,392,1,receive,262794641371,1098359
262795740417,136,1,receive,262794642655,1097762
262795741104,422,1,receive,262794642630,1098474
262795741776,142,1,receive,262794643116,1098660
262795861742,90,1,receive,262794644062,1217680
262795862433,278,1,receive,262794645016,1217417
262795863122,132,1,receive,262794645162,1217960
262795863810,96,1,receive,262794645700,1218110
262795864496,262,1,receive,262794646137,1218359
262795944921,82,1,receive,262794647666,1297255
262795945602,110,1,receive,262794648198,1297404
262795946268,12,1,receive,262794651507,1294761
262795946926,372,1,receive,262794651592,1295334
262795947609,156,1,receive,262794652107,1295502
262796051624,198,1,receive,262794652771,1398853
262796052291,186,1,receive,262794653417,1398874
262796052940,16,1,receive,262794654371,1398569
262796053599,376,1,receive,262794656043,1397556
262796054275,582,1,receive,262794656105,1398170
262796054964,380,1,receive,262794656620,1398344
262796142844,210,1,receive,262794657065,1485779
262796143523,580,1,receive,262794657773,1485750
262796144259,218,1,receive,262794659052,1485207
262796144952,596,1,receive,262794659861,1485091
262796196374,50,1,receive,262794660037,1536337
262796197903,76,1,receive,262794660045,1537858
262796215184,44,1,receive,262794661029,1554155
262796233619,592,1,receive,262794664405,1569214
262796234296,420,1,receive,262794665047,1569249
262796234950,588,1,receive,262794665889,1569061
262796335236,150,1,receive,262794668319,1666917
262796335935,632,1,receive,262794668908,1667027
262796336621,164,1,receive,262794669151,1667470
262796337302,384,1,receive,262794669749,1667553
262796337969,14,1,receive,262794650105,1687864
262796435020,542,1,receive,262794672968,1762052
262796435711,628,1,receive,262794676074,1759637
262796436396,52,1,receive,262794677035,1759361
262796437080,590,1,receive,262794679633,1757447
262796437763,170,1,receive,262794680405,1757358
262796537198,226,1,receive,262794680969,1856229
262796537896,364,1,receive,262794682340,1855556
262796538563,10,1,receive,262794651651,1886912
262796539234,88,1,receive,262794684352,1854882
262796539898,134,1,receive,262794684917,1854981
262796627245,358,1,receive,262794685038,1942207
262796627933,120,1,receive,262794685420,1942513
262796628624,758,1,receive,262794685979,1942645
262796629313,166,1,receive,262794688499,1940814
262796743361,208,1,receive,262794691855,2051506
262796744071,344,1,receive,262794693037,2051034
262796744760,832,1,receive,262794694048,2050712
262796751961,794,1,receive,262794695138,2056823
262796786138,442,1,receive,262794697452,2088686
262796786828,450,1,receive,262794698023,2088805
262796859843,162,1,receive,262794700773,2159070
262796860537,802,1,receive,262794702973,2157564
262796861229,812,1,receive,262794703956,2157273
262796861921,834,1,receive,262794704045,2157876
262796862605,126,1,receive,262794705053,2157552
262796988288,824,1,receive,262794709244,2279044
262796988950,818,1,receive,262794710825,2278125
262797003455,552,1,receive,262794712774,2290681
262797033025,752,1,receive,262794715035,2317990
262797094442,274,1,receive,262794718059,2376383
262797095146,830,1,receive,262794719284,2375862
262797095829,480,1,receive,262794719296,2376533
262797096503,822,1,receive,262794719860,2376643
262797097168,618,1,receive,262794721795,2375373
262797097828,520,1,receive,262794730338,2367490
262797229146,630,1,receive,262794730659,2498487
262797229980,500,1,receive,262794731099,2498881
262797230645,526,1,receive,262794732762,2497883
262797231303,348,1,receive,262794733707,2497596
262797231961,508,1,receive,262794734772,2497189
262797336892,836,1,receive,262794737218,2599674
262797337558,792,1,receive,262794738039,2599519
262797338222,762,1,receive,262794738054,2600168
262797338881,820,1,receive,262794738579,2600302
262797339568,168,1,receive,262794739068,2600500
262797469582,454,1,receive,262794739055,2730527
262797470258,354,1,receive,262794739204,2731054
262797470921,840,1,receive,262794739718,2731203
262797471587,388,1,receive,262794699467,2772120
262797472251,488,1,receive,262794741721,2730530
262797472910,92,1,receive,262794651844,2821066
262797634601,202,1,receive,262794745539,2889062
262797636553,816,1,receive,262794745511,2891042
262797637200,244,1,receive,262794745732,2891468
262797637829,212,1,receive,262794749217,2888612
262797638480,432,1,receive,262794657302,2981178
262797770146,178,1,receive,262794679202,3090944
262797770792,352,1,receive,262794747193,3023599
262797771451,610,1,receive,262794753207,3018244
262797772117,634,1,receive,262794756062,3016055
262797811223,540,1,receive,262794759061,3052162
262797888373,786,1,receive,262794759277,3129096
262797889035,494,1,receive,262794759442,3129593
262797889707,482,1,receive,262794759783,3129924
262797890380,838,1,receive,262794760973,3129407
262797891053,736,1,receive,262794761059,3129994
262797891703,712,1,receive,262794765916,3125787
262798011934,606,1,receive,262794767049,3244885
262798012596,594,1,receive,262794771037,3241559
262798013269,62,1,receive,262794771460,3241809
262798013942,236,1,receive,262794669024,3344918
262798014619,356,1,receive,262794775038,3239581
262798142625,724,1,receive,262794775084,3367541
262798143312,722,1,receive,262794775712,3367600
262798143985,788,1,receive,262794776734,3367251
262798144663,638,1,receive,262794777049,3367614
262798145336,466,1,receive,262794779063,3366273
262798145988,754,1,receive,262794779855,3366133
262798276782,744,1,receive,262794782098,3494684
262798277459,718,1,receive,262794784101,3493358
262798278137,58,1,receive,262794634580,3643557
262798278811,852,1,receive,262794785938,3492873
262798279453,842,1,receive,262794787098,3492355
262798412429,140,1,receive,262794705034,3707395
262798413103,874,1,receive,262794790712,3622391
262798413792,608,1,receive,262794791047,3622745
262798414448,740,1,receive,262794791185,3623263
262798415092,862,1,receive,262794791404,3623688
262798415739,586,1,receive,262794773034,3642705
262798540417,680,1,receive,262794800964,3739453
262798541098,556,1,receive,262794801210,3739888
262798541758,80,1,receive,262794753077,3788681
262798542427,810,1,receive,262794800687,3741740
262798543080,682,1,receive,262794803273,3739807
262798661816,848,1,receive,262794804357,3857459
262798662472,688,1,receive,262794805146,3857326
262798663200,670,1,receive,262794805425,3857775
262798663876,706,1,receive,262794805754,3858122
262798664557,532,1,receive,262794804039,3860518
262798777244,866,1,receive,262794807290,3969954
262798777918,846,1,receive,262794808433,3969485
262798778586,700,1,receive,262794808661,3969925
262798779261,666,1,receive,262794808832,3970429
262798779938,726,1,receive,262794809152,3970786
262798899205,886,1,receive,262794809654,4089551
262798899853,280,1,receive,262794804038,4095815
262798900518,534,1,receive,262794810019,4090499
262798905413,742,1,receive,262794810046,4095367
262798906089,734,1,receive,262794805975,4100114
262798906763,738,1,receive,262794804564,4102199
262799025443,578,1,receive,262794813571,4211872
262799026076,614,1,receive,262794818064,4208012
262799026731,766,1,receive,262794818592,4208139
262799048391,814,1,receive,262794819547,4228844
262799129974,760,1,receive,262794820818,4309156
262799130635,620,1,receive,262794817830,4312805
262799131548,864,1,receive,262794816273,4315275
262799132225,612,1,receive,262794824582,4307643
262799132899,768,1,receive,262794826059,4306840
262799133573,472,1,receive,262794824203,4309370
262799276085,890,1,receive,262794828041,4448044
262799276729,902,1,receive,262794828444,4448285
262799277396,878,1,receive,262794829373,4448023
262799278081,558,1,receive,262794826751,4451330
262799278759,882,1,receive,262794827769,4450990
262799380244,730,1,receive,262794831114,4549130
262799380892,780,1,receive,262794831798,4549094
262799381545,32,1,receive,262794664030,4717515
262799382197,174,1,receive,262794707028,4675169
262799382850,538,1,receive,262794831395,4551455
262799502842,774,1,receive,262794834551,4668291
262799503521,782,1,receive,262794831156,4672365
262799504202,636,1,receive,262794835757,4668445
262799504873,230,1,receive,262794836017,4668856
262799505532,568,1,receive,262794828903,4676629
262799638664,276,1,receive,262794718788,4919876
262799639319,184,1,receive,262794837518,4801801
262799639968,888,1,receive,262794838015,4801953
262799640635,708,1,receive,262794823509,4817126
262799641308,704,1,receive,262794836511,4804797
262799753166,536,1,receive,262794827439,4925727
262799753837,884,1,receive,262794818675,4935162
262799754504,880,1,receive,262794828803,4925701
262799755173,856,1,receive,262794841630,4913543
262799755824,674,1,receive,262794842731,4913093
262799841523,678,1,receive,262794849031,4992492
262799842233,868,1,receive,262794833809,5008424
262799842977,698,1,receive,262794848604,4994373
262799843659,806,1,receive,262794853081,4990578
262799844330,778,1,receive,262794855512,4988818
262799844981,720,1,receive,262794843242,5001739
262799951515,844,1,receive,262794842017,5109498
262799952176,900,1,receive,262794839300,5112876
262799952833,464,1,receive,262794827781,5125052
262799953507,804,1,receive,262794860983,5092524
262800039704,444,1,receive,262794861645,5178059
262800040371,790,1,receive,262794850137,5190234
262800041048,896,1,receive,262794858653,5182395
262800055409,870,1,receive,262794831029,5224380
262800056063,912,1,receive,262794858038,5198025
262800056715,116,1,receive,262794852130,5204585
262800156249,716,1,receive,262794853883,5302366
262800156911,876,1,receive,262794852260,5304651
262800157593,732,1,receive,262794852037,5305556
262800180274,854,1,receive,262794864460,5315814
262800180949,914,1,receive,262794874858,5306091
262800261618,828,1,receive,262794871988,5389630
262800262279,910,1,receive,262794873486,5388793
262800262958,892,1,receive,262794863422,5399536
262800263641,600,1,receive,262794874615,5389026
262800264324,924,1,receive,262794879157,5385167
262800264971,124,2,receive,262794780600,5484371
262800386556,918,1,receive,262794884191,5502365
262800387231,858,1,receive,262794875062,5512169
262800387920,628,2,receive,262794887482,5500438
262800388597,222,1,receive,262794858074,5530523
262800454311,826,1,receive,262794888886,5565425
262800455008,908,1,receive,262794887953,5567055
262800455702,916,1,receive,262794895909,5559793
262800456402,898,1,receive,262794897612,5558790
262800457107,206,1,receive,262794894084,5563023
262800457796,906,1,receive,262794896323,5561473
262800596691,176,1,receive,262794885163,5711528
262800597387,850,1,receive,262794880639,5716748
262800598089,702,1,receive,262794859037,5739052
262800598756,920,1,receive,262794906037,5692719
262800599454,904,1,receive,262794898967,5700487
262800701365,104,1,receive,262794693040,6008325
262800701991,894,1,receive,262794910035,5791956
262800702620,714,1,receive,262794869932,5832688
262800703326,432,2,receive,262794897567,5805759
262800731612,362,1,receive,262794890412,5841200
262800804190,74,2,receive,262794891949,5912241
262800804867,138,1,receive,262794906230,5898637
262800805583,872,1,receive,262794868647,5936936
262800806251,926,1,receive,262794922243,5884008
262800806900,860,1,receive,262794864783,5942117
262800881927,888,2,receive,262794981489,5900438
262800882596,956,1,receive,262794984049,5898547
262800883285,508,2,receive,262794961472,5921813
262800883950,262,2,receive,262794986507,5897443
262800884623,962,1,receive,262794987230,5897393
262800968506,220,1,receive,262794979264,5989242
262800969181,838,2,receive,262794990251,5978930
262800969868,930,1,receive,262794990426,5979442
262800978253,700,2,receive,262794990760,5987493
262800978938,418,1,receive,262794895366,6083572
262801040754,12,2,receive,262794920545,6120209
262801041445,382,1,receive,262795125558,5915887
262801042142,494,2,receive,262795094268,5947874
262801077180,952,2,receive,262795130580,5946600
262801136842,978,1,receive,262795121129,6015713
262801137539,702,2,receive,262795104028,6033511
262801138229,790,2,receive,262795139013,5999216
262801138918,14,2,receive,262795227167,5911751
262801139614,854,2,receive,262795025945,6113669
262801214534,62,2,receive,262795198065,6016469
262801215205,682,2,receive,262795174077,6041128
262801215869,76,2,receive,262795242141,5973728
262801216532,480,3,receive,262795365448,5851084
262801217200,876,2,receive,262795299282,5917918
262801217861,224,1,receive,262795360803,5857058
262801307083,674,2,receive,262795319006,5988077
262801307775,806,2,receive,262795326007,5981768
262801308473,532,3,receive,262795382857,5925616
262801309171,556,3,receive,262795491005,5818166
262801309855,384,3,receive,262795398006,5911849
262801387242,826,2,receive,262795477450,5909792
262801387890,106,2,receive,262795409827,5978063
262801388598,218,2,receive,262795411014,5977584
262801389290,588,2,receive,262795586010,5803280
262801389978,398,2,receive,262795615009,5774969
262801492881,734,2,receive,262795601499,5891382
262801493568,388,3,receive,262795648371,5845197
262801505662,762,2,receive,262795683639,5822023
262801527331,464,2,receive,262795701111,5826220
262801575376,960,2,receive,262795749079,5826297
262801576078,148,2,receive,262795696007,5880071
262801576769,34,4,receive,262795690020,5886749
262801577433,880,3,receive,262795736091,5841342
262801578123,934,3,receive,262795799069,5779054
262801578810,224,3,receive,262795800081,5778729
